name	cuisine	instructions
宫保鸡丁	川菜	1) 鸡胸肉切1.5cm丁，加少许盐、料酒、淀粉与少许油抓匀腌10分钟。\n2) 调宫保汁：生抽2、老抽1/2、米醋2、糖3、盐少许、淀粉少许、清水3、花椒油少许。\n3) 花生米冷油小火炸酥捞出；锅中留底油，下干辣椒节与花椒小火炒香。\n4) 大火下鸡丁滑散至变色，倒入宫保汁翻炒，迅速收浓。\n5) 起锅前下葱段与花生米，翻匀出锅。
麻婆豆腐	川菜	1) 嫩豆腐切2cm方块，开水加盐轻焯30秒捞出备用；牛/猪肉末少许。\n2) 郫县豆瓣剁细，蒜姜末、花椒粉、葱花备好；调芡水：生抽1、糖1/2、淀粉与清水适量。\n3) 锅中宽油小火炒豆瓣至出红油，下肉末炒散，再下蒜姜末与花椒粉。\n4) 倒入热水或高汤，轻推入豆腐，小火微沸5分钟入味。\n5) 淋芡水轻轻晃锅至汤汁微稠，撒葱花，淋花椒油出锅。
鱼香肉丝	川菜	1) 主料处理：肉丝切条/片，加少许盐与油拌匀，腌10分钟；辅料如木耳/笋/胡萝卜按需切条。\n2) 调鱼香汁：生抽2、老抽1/2、米醋2、白糖3、郫县豆瓣1、蒜姜末各适量、清水与淀粉调稀。\n3) 锅中少油，下豆瓣小火炒红油，入蒜姜与泡椒末炒香。\n4) 下肉丝大火快炒至变色，加入辅料翻匀。\n5) 沿锅边倒入鱼香汁，翻炒至汤汁浓亮、均匀裹附，出锅。
回锅肉	川菜	1) 五花肉冷水入锅加姜葱与料酒，小火煮至筷子能插入，晾凉切0.3cm薄片。\n2) 青蒜切段、郫县豆瓣与甜面酱各1勺备用。\n3) 锅不放油中小火煸肉片出油卷边，推一旁，下豆瓣炒红油，再加甜面酱、生抽少许炒匀。\n4) 下青蒜大火翻炒断生，少许糖提鲜，出锅前点醋去腥提香。
水煮鱼	川菜	1) 草鱼片厚约4mm，盐+料酒+淀粉抓匀腌10分钟；豆芽/莴笋垫底。\n2) 郫县豆瓣+干辣椒+花椒炒红油，加高汤煮开，调盐与糖。\n3) 下鱼片滑散断生即捞起铺在蔬菜上；原汤过滤后浇上。\n4) 另起锅烧热油，撒上干辣椒节与花椒，泼在鱼面；撒蒜末与葱花。
水煮牛肉	川菜	1) 牛肉切片/段，加少许盐、料酒、生抽与淀粉抓匀；豆芽/莴笋等蔬菜焯水垫底。\n2) 郫县豆瓣+干辣椒+花椒炒出红油，加高汤煮沸调咸淡。\n3) 下牛肉滑散至断生捞出，铺在蔬菜上；原汤过滤浇上。\n4) 另起锅烧热油，撒干辣椒与花椒，趁热泼在表面，撒蒜末葱花。
辣子鸡	川菜	1) 主料改刀并腌制（盐/料酒/少许生抽/淀粉）。\n2) 锅中下豆瓣/干辣椒/花椒炒香，入主料大火快炒。\n3) 以生抽/糖/少量醋调味，收汁见油亮即成。
口水鸡	川菜	1) 主料改刀并腌制（盐/料酒/少许生抽/淀粉）。\n2) 锅中下豆瓣/干辣椒/花椒炒香，入主料大火快炒。\n3) 以生抽/糖/少量醋调味，收汁见油亮即成。
夫妻肺片	川菜	1) 主料改刀并腌制（盐/料酒/少许生抽/淀粉）。\n2) 锅中下豆瓣/干辣椒/花椒炒香，入主料大火快炒。\n3) 以生抽/糖/少量醋调味，收汁见油亮即成。
毛血旺	川菜	1) 主料改刀并腌制（盐/料酒/少许生抽/淀粉）。\n2) 锅中下豆瓣/干辣椒/花椒炒香，入主料大火快炒。\n3) 以生抽/糖/少量醋调味，收汁见油亮即成。
酸菜鱼	川菜	1) 主料改刀并腌制（盐/料酒/少许生抽/淀粉）。\n2) 锅中下豆瓣/干辣椒/花椒炒香，入主料大火快炒。\n3) 以生抽/糖/少量醋调味，收汁见油亮即成。
担担面	川菜	1) 主料改刀并腌制（盐/料酒/少许生抽/淀粉）。\n2) 锅中下豆瓣/干辣椒/花椒炒香，入主料大火快炒。\n3) 以生抽/糖/少量醋调味，收汁见油亮即成。
重庆小面	川菜	1) 碗底：生抽2、老抽1/2、香醋1、盐与味精少许、花椒面、蒜水、葱花、熟芝麻。\n2) 辣油：豆瓣小火炒香加辣椒粉与花椒粉，浇入热油静置成红油。\n3) 面条大火煮至断生，迅速入碗；加滚烫骨汤或清水，拌匀即可；可加芽菜碎/油渣。
钵钵鸡	川菜	1) 主料改刀并腌制（盐/料酒/少许生抽/淀粉）。\n2) 锅中下豆瓣/干辣椒/花椒炒香，入主料大火快炒。\n3) 以生抽/糖/少量醋调味，收汁见油亮即成。
串串香	川菜	1) 主料改刀并腌制（盐/料酒/少许生抽/淀粉）。\n2) 锅中下豆瓣/干辣椒/花椒炒香，入主料大火快炒。\n3) 以生抽/糖/少量醋调味，收汁见油亮即成。
麻辣香锅	川菜	1) 香锅切块/段，加少许盐与油拌匀；干辣椒段、花椒粒、蒜片、姜片、葱段备好。\n2) 锅入少许底油，小火炒香花椒与干辣椒，出香不糊。\n3) 下香锅大火翻炒至断生，烹生抽/料酒，少许糖提味。\n4) 继续翻炒至入味，可加少量高汤，收至微干；撒葱段芝麻。
麻辣烫	川菜	1) 烫切块/段，加少许盐与油拌匀；干辣椒段、花椒粒、蒜片、姜片、葱段备好。\n2) 锅入少许底油，小火炒香花椒与干辣椒，出香不糊。\n3) 下烫大火翻炒至断生，烹生抽/料酒，少许糖提味。\n4) 继续翻炒至入味，可加少量高汤，收至微干；撒葱段芝麻。
泡椒凤爪	川菜	1) 凤爪切块/段，加少许盐与油拌匀；泡椒切碎、泡椒汁留用。\n2) 爆香姜蒜，下泡椒炒出酸辣味。\n3) 下凤爪快炒，烹少量泡椒汁与生抽，加入少许糖平衡。\n4) 出锅前点少量香醋与葱段，味鲜开胃。
芋儿鸡	川菜	1) 主料改刀并腌制（盐/料酒/少许生抽/淀粉）。\n2) 锅中下豆瓣/干辣椒/花椒炒香，入主料大火快炒。\n3) 以生抽/糖/少量醋调味，收汁见油亮即成。
红油抄手	川菜	1) 猪肉馅加盐/生抽/料酒/姜水/少许油拌匀；抄手皮包好。\n2) 红油碗底：生抽、陈醋、糖、蒜末、花椒面、辣油、葱花、少量热油。\n3) 抄手入沸水煮至浮起熟透，捞入碗底拌匀，撒葱花与熟芝麻。
川北凉粉	川菜	1) 主料改刀并腌制（盐/料酒/少许生抽/淀粉）。\n2) 锅中下豆瓣/干辣椒/花椒炒香，入主料大火快炒。\n3) 以生抽/糖/少量醋调味，收汁见油亮即成。
豆花	川菜	1) 主料改刀并腌制（盐/料酒/少许生抽/淀粉）。\n2) 锅中下豆瓣/干辣椒/花椒炒香，入主料大火快炒。\n3) 以生抽/糖/少量醋调味，收汁见油亮即成。
酸辣粉	川菜	1) 主料改刀并腌制（盐/料酒/少许生抽/淀粉）。\n2) 锅中下豆瓣/干辣椒/花椒炒香，入主料大火快炒。\n3) 以生抽/糖/少量醋调味，收汁见油亮即成。
椒麻鸡	川菜	1) 鸡腿冷水下锅加姜葱与盐，小火煮12~15分钟，关火焖10分钟，取出冰水过凉后切块。\n2) 调汁：花椒油2、鲜花椒碎、盐、糖少许、蒜末、葱花、香菜末、少量鸡汤或凉开水。\n3) 浇在鸡块上拌匀即可。
歌乐山辣子鸡	川菜	1) 主料改刀并腌制（盐/料酒/少许生抽/淀粉）。\n2) 锅中下豆瓣/干辣椒/花椒炒香，入主料大火快炒。\n3) 以生抽/糖/少量醋调味，收汁见油亮即成。
豆瓣鲫鱼	川菜	1) 主料改刀并腌制（盐/料酒/少许生抽/淀粉）。\n2) 锅中下豆瓣/干辣椒/花椒炒香，入主料大火快炒。\n3) 以生抽/糖/少量醋调味，收汁见油亮即成。
锅巴肉片	川菜	1) 主料改刀并腌制（盐/料酒/少许生抽/淀粉）。\n2) 锅中下豆瓣/干辣椒/花椒炒香，入主料大火快炒。\n3) 以生抽/糖/少量醋调味，收汁见油亮即成。
沸腾鱼	川菜	1) 主料改刀并腌制（盐/料酒/少许生抽/淀粉）。\n2) 锅中下豆瓣/干辣椒/花椒炒香，入主料大火快炒。\n3) 以生抽/糖/少量醋调味，收汁见油亮即成。
酸菜牛肉	川菜	1) 主料改刀并腌制（盐/料酒/少许生抽/淀粉）。\n2) 锅中下豆瓣/干辣椒/花椒炒香，入主料大火快炒。\n3) 以生抽/糖/少量醋调味，收汁见油亮即成。
干锅花菜	川菜	1) 花菜预处理：肉类先腌后滑油/焯水，蔬菜如洋葱/芹菜/藕片备好。\n2) 锅中底油，下豆瓣/辣椒面/花椒炒香，少许火锅底料增香。\n3) 下花菜翻炒断生，加入配菜大火煸香。\n4) 调入生抽/老抽/糖/少量高汤，收至干香，撒葱段与芝麻，上桌可置小炉保温。
干锅牛蛙	川菜	1) 牛蛙预处理：肉类先腌后滑油/焯水，蔬菜如洋葱/芹菜/藕片备好。\n2) 锅中底油，下豆瓣/辣椒面/花椒炒香，少许火锅底料增香。\n3) 下牛蛙翻炒断生，加入配菜大火煸香。\n4) 调入生抽/老抽/糖/少量高汤，收至干香，撒葱段与芝麻，上桌可置小炉保温。
干锅肥肠	川菜	1) 肥肠预处理：肉类先腌后滑油/焯水，蔬菜如洋葱/芹菜/藕片备好。\n2) 锅中底油，下豆瓣/辣椒面/花椒炒香，少许火锅底料增香。\n3) 下肥肠翻炒断生，加入配菜大火煸香。\n4) 调入生抽/老抽/糖/少量高汤，收至干香，撒葱段与芝麻，上桌可置小炉保温。
泡椒牛蛙	川菜	1) 牛蛙切块/段，加少许盐、料酒、生抽与淀粉抓匀；泡椒切碎、泡椒汁留用。\n2) 爆香姜蒜，下泡椒炒出酸辣味。\n3) 下牛蛙快炒，烹少量泡椒汁与生抽，加入少许糖平衡。\n4) 出锅前点少量香醋与葱段，味鲜开胃。
鱼香茄子	川菜	1) 主料处理：茄子切条/片，加少许盐与油拌匀，腌10分钟；辅料如木耳/笋/胡萝卜按需切条。\n2) 调鱼香汁：生抽2、老抽1/2、米醋2、白糖3、郫县豆瓣1、蒜姜末各适量、清水与淀粉调稀。\n3) 锅中少油，下豆瓣小火炒红油，入蒜姜与泡椒末炒香。\n4) 下茄子大火快炒至变色，加入辅料翻匀。\n5) 沿锅边倒入鱼香汁，翻炒至汤汁浓亮、均匀裹附，出锅。
蒜泥白肉	川菜	1) 五花肉整块冷水下锅加姜葱与料酒，小火煮至筷子易插入，冷却后切薄片。\n2) 蒜泥加生抽、香醋、糖、辣椒油、花椒油、少量冷开水调成汁。\n3) 黄瓜/豆芽垫底，铺肉片，淋蒜泥，点红油与葱花。
樟茶鸭	川菜	1) 主料改刀并腌制（盐/料酒/少许生抽/淀粉）。\n2) 锅中下豆瓣/干辣椒/花椒炒香，入主料大火快炒。\n3) 以生抽/糖/少量醋调味，收汁见油亮即成。
怪味鸡	川菜	1) 主料改刀并腌制（盐/料酒/少许生抽/淀粉）。\n2) 锅中下豆瓣/干辣椒/花椒炒香，入主料大火快炒。\n3) 以生抽/糖/少量醋调味，收汁见油亮即成。
烧椒皮蛋	川菜	1) 主料改刀并腌制（盐/料酒/少许生抽/淀粉）。\n2) 锅中下豆瓣/干辣椒/花椒炒香，入主料大火快炒。\n3) 以生抽/糖/少量醋调味，收汁见油亮即成。
泡菜排骨	川菜	1) 主料改刀并腌制（盐/料酒/少许生抽/淀粉）。\n2) 锅中下豆瓣/干辣椒/花椒炒香，入主料大火快炒。\n3) 以生抽/糖/少量醋调味，收汁见油亮即成。
藤椒鸡	川菜	1) 鸡处理并腌制；藤椒（青花椒）用温油浸香，取藤椒油。\n2) 锅中下藤椒油与少量生姜蒜，炒至清香。\n3) 下鸡快炒，烹少量鸡汤/清水，加盐与白胡椒调味。\n4) 出锅前再淋藤椒油，口味清香麻爽。
鱼香鸡	川菜	1) 主料处理：鸡切条/片，加少许盐、料酒、胡椒与淀粉抓匀，腌10分钟；辅料如木耳/笋/胡萝卜按需切条。\n2) 调鱼香汁：生抽2、老抽1/2、米醋2、白糖3、郫县豆瓣1、蒜姜末各适量、清水与淀粉调稀。\n3) 锅中少油，下豆瓣小火炒红油，入蒜姜与泡椒末炒香。\n4) 下鸡大火快炒至变色，加入辅料翻匀。\n5) 沿锅边倒入鱼香汁，翻炒至汤汁浓亮、均匀裹附，出锅。
鱼香鸡翅	川菜	1) 主料处理：鸡翅切条/片，加少许盐、料酒、胡椒与淀粉抓匀，腌10分钟；辅料如木耳/笋/胡萝卜按需切条。\n2) 调鱼香汁：生抽2、老抽1/2、米醋2、白糖3、郫县豆瓣1、蒜姜末各适量、清水与淀粉调稀。\n3) 锅中少油，下豆瓣小火炒红油，入蒜姜与泡椒末炒香。\n4) 下鸡翅大火快炒至变色，加入辅料翻匀。\n5) 沿锅边倒入鱼香汁，翻炒至汤汁浓亮、均匀裹附，出锅。
鱼香鸡爪	川菜	1) 主料处理：鸡爪切条/片，加少许盐、料酒、胡椒与淀粉抓匀，腌10分钟；辅料如木耳/笋/胡萝卜按需切条。\n2) 调鱼香汁：生抽2、老抽1/2、米醋2、白糖3、郫县豆瓣1、蒜姜末各适量、清水与淀粉调稀。\n3) 锅中少油，下豆瓣小火炒红油，入蒜姜与泡椒末炒香。\n4) 下鸡爪大火快炒至变色，加入辅料翻匀。\n5) 沿锅边倒入鱼香汁，翻炒至汤汁浓亮、均匀裹附，出锅。
鱼香牛肉	川菜	1) 主料处理：牛肉切条/片，加少许盐、料酒、生抽与淀粉抓匀，腌10分钟；辅料如木耳/笋/胡萝卜按需切条。\n2) 调鱼香汁：生抽2、老抽1/2、米醋2、白糖3、郫县豆瓣1、蒜姜末各适量、清水与淀粉调稀。\n3) 锅中少油，下豆瓣小火炒红油，入蒜姜与泡椒末炒香。\n4) 下牛肉大火快炒至变色，加入辅料翻匀。\n5) 沿锅边倒入鱼香汁，翻炒至汤汁浓亮、均匀裹附，出锅。
鱼香猪肉	川菜	1) 主料处理：猪肉切条/片，加少许盐、料酒、生抽与淀粉抓匀，腌10分钟；辅料如木耳/笋/胡萝卜按需切条。\n2) 调鱼香汁：生抽2、老抽1/2、米醋2、白糖3、郫县豆瓣1、蒜姜末各适量、清水与淀粉调稀。\n3) 锅中少油，下豆瓣小火炒红油，入蒜姜与泡椒末炒香。\n4) 下猪肉大火快炒至变色，加入辅料翻匀。\n5) 沿锅边倒入鱼香汁，翻炒至汤汁浓亮、均匀裹附，出锅。
鱼香排骨	川菜	1) 主料处理：排骨切条/片，加少许盐与油拌匀，腌10分钟；辅料如木耳/笋/胡萝卜按需切条。\n2) 调鱼香汁：生抽2、老抽1/2、米醋2、白糖3、郫县豆瓣1、蒜姜末各适量、清水与淀粉调稀。\n3) 锅中少油，下豆瓣小火炒红油，入蒜姜与泡椒末炒香。\n4) 下排骨大火快炒至变色，加入辅料翻匀。\n5) 沿锅边倒入鱼香汁，翻炒至汤汁浓亮、均匀裹附，出锅。
鱼香虾	川菜	1) 主料处理：虾切条/片，加少许盐、料酒与淀粉抓匀去腥，腌10分钟；辅料如木耳/笋/胡萝卜按需切条。\n2) 调鱼香汁：生抽2、老抽1/2、米醋2、白糖3、郫县豆瓣1、蒜姜末各适量、清水与淀粉调稀。\n3) 锅中少油，下豆瓣小火炒红油，入蒜姜与泡椒末炒香。\n4) 下虾大火快炒至变色，加入辅料翻匀。\n5) 沿锅边倒入鱼香汁，翻炒至汤汁浓亮、均匀裹附，出锅。
鱼香虾仁	川菜	1) 主料处理：虾仁切条/片，加少许盐、料酒与淀粉抓匀去腥，腌10分钟；辅料如木耳/笋/胡萝卜按需切条。\n2) 调鱼香汁：生抽2、老抽1/2、米醋2、白糖3、郫县豆瓣1、蒜姜末各适量、清水与淀粉调稀。\n3) 锅中少油，下豆瓣小火炒红油，入蒜姜与泡椒末炒香。\n4) 下虾仁大火快炒至变色，加入辅料翻匀。\n5) 沿锅边倒入鱼香汁，翻炒至汤汁浓亮、均匀裹附，出锅。
鱼香腰花	川菜	1) 主料处理：腰花切条/片，加少许盐与油拌匀，腌10分钟；辅料如木耳/笋/胡萝卜按需切条。\n2) 调鱼香汁：生抽2、老抽1/2、米醋2、白糖3、郫县豆瓣1、蒜姜末各适量、清水与淀粉调稀。\n3) 锅中少油，下豆瓣小火炒红油，入蒜姜与泡椒末炒香。\n4) 下腰花大火快炒至变色，加入辅料翻匀。\n5) 沿锅边倒入鱼香汁，翻炒至汤汁浓亮、均匀裹附，出锅。
鱼香肥肠	川菜	1) 主料处理：肥肠切条/片，加少许盐、料酒、生抽与淀粉抓匀，腌10分钟；辅料如木耳/笋/胡萝卜按需切条。\n2) 调鱼香汁：生抽2、老抽1/2、米醋2、白糖3、郫县豆瓣1、蒜姜末各适量、清水与淀粉调稀。\n3) 锅中少油，下豆瓣小火炒红油，入蒜姜与泡椒末炒香。\n4) 下肥肠大火快炒至变色，加入辅料翻匀。\n5) 沿锅边倒入鱼香汁，翻炒至汤汁浓亮、均匀裹附，出锅。
鱼香牛蛙	川菜	1) 主料处理：牛蛙切条/片，加少许盐、料酒、生抽与淀粉抓匀，腌10分钟；辅料如木耳/笋/胡萝卜按需切条。\n2) 调鱼香汁：生抽2、老抽1/2、米醋2、白糖3、郫县豆瓣1、蒜姜末各适量、清水与淀粉调稀。\n3) 锅中少油，下豆瓣小火炒红油，入蒜姜与泡椒末炒香。\n4) 下牛蛙大火快炒至变色，加入辅料翻匀。\n5) 沿锅边倒入鱼香汁，翻炒至汤汁浓亮、均匀裹附，出锅。
鱼香鸭	川菜	1) 主料处理：鸭切条/片，加少许盐、料酒、胡椒与淀粉抓匀，腌10分钟；辅料如木耳/笋/胡萝卜按需切条。\n2) 调鱼香汁：生抽2、老抽1/2、米醋2、白糖3、郫县豆瓣1、蒜姜末各适量、清水与淀粉调稀。\n3) 锅中少油，下豆瓣小火炒红油，入蒜姜与泡椒末炒香。\n4) 下鸭大火快炒至变色，加入辅料翻匀。\n5) 沿锅边倒入鱼香汁，翻炒至汤汁浓亮、均匀裹附，出锅。
鱼香鳝鱼	川菜	1) 主料处理：鳝鱼切条/片，加少许盐、料酒与淀粉抓匀去腥，腌10分钟；辅料如木耳/笋/胡萝卜按需切条。\n2) 调鱼香汁：生抽2、老抽1/2、米醋2、白糖3、郫县豆瓣1、蒜姜末各适量、清水与淀粉调稀。\n3) 锅中少油，下豆瓣小火炒红油，入蒜姜与泡椒末炒香。\n4) 下鳝鱼大火快炒至变色，加入辅料翻匀。\n5) 沿锅边倒入鱼香汁，翻炒至汤汁浓亮、均匀裹附，出锅。
鱼香鲈鱼	川菜	1) 主料处理：鲈鱼切条/片，加少许盐、料酒与淀粉抓匀去腥，腌10分钟；辅料如木耳/笋/胡萝卜按需切条。\n2) 调鱼香汁：生抽2、老抽1/2、米醋2、白糖3、郫县豆瓣1、蒜姜末各适量、清水与淀粉调稀。\n3) 锅中少油，下豆瓣小火炒红油，入蒜姜与泡椒末炒香。\n4) 下鲈鱼大火快炒至变色，加入辅料翻匀。\n5) 沿锅边倒入鱼香汁，翻炒至汤汁浓亮、均匀裹附，出锅。
鱼香草鱼	川菜	1) 主料处理：草鱼切条/片，加少许盐、料酒与淀粉抓匀去腥，腌10分钟；辅料如木耳/笋/胡萝卜按需切条。\n2) 调鱼香汁：生抽2、老抽1/2、米醋2、白糖3、郫县豆瓣1、蒜姜末各适量、清水与淀粉调稀。\n3) 锅中少油，下豆瓣小火炒红油，入蒜姜与泡椒末炒香。\n4) 下草鱼大火快炒至变色，加入辅料翻匀。\n5) 沿锅边倒入鱼香汁，翻炒至汤汁浓亮、均匀裹附，出锅。
鱼香鲫鱼	川菜	1) 主料处理：鲫鱼切条/片，加少许盐、料酒与淀粉抓匀去腥，腌10分钟；辅料如木耳/笋/胡萝卜按需切条。\n2) 调鱼香汁：生抽2、老抽1/2、米醋2、白糖3、郫县豆瓣1、蒜姜末各适量、清水与淀粉调稀。\n3) 锅中少油，下豆瓣小火炒红油，入蒜姜与泡椒末炒香。\n4) 下鲫鱼大火快炒至变色，加入辅料翻匀。\n5) 沿锅边倒入鱼香汁，翻炒至汤汁浓亮、均匀裹附，出锅。
鱼香带鱼	川菜	1) 主料处理：带鱼切条/片，加少许盐、料酒与淀粉抓匀去腥，腌10分钟；辅料如木耳/笋/胡萝卜按需切条。\n2) 调鱼香汁：生抽2、老抽1/2、米醋2、白糖3、郫县豆瓣1、蒜姜末各适量、清水与淀粉调稀。\n3) 锅中少油，下豆瓣小火炒红油，入蒜姜与泡椒末炒香。\n4) 下带鱼大火快炒至变色，加入辅料翻匀。\n5) 沿锅边倒入鱼香汁，翻炒至汤汁浓亮、均匀裹附，出锅。
鱼香豆腐	川菜	1) 主料处理：豆腐切条/片，加少许盐与油拌匀，腌10分钟；辅料如木耳/笋/胡萝卜按需切条。\n2) 调鱼香汁：生抽2、老抽1/2、米醋2、白糖3、郫县豆瓣1、蒜姜末各适量、清水与淀粉调稀。\n3) 锅中少油，下豆瓣小火炒红油，入蒜姜与泡椒末炒香。\n4) 下豆腐大火快炒至变色，加入辅料翻匀。\n5) 沿锅边倒入鱼香汁，翻炒至汤汁浓亮、均匀裹附，出锅。
鱼香土豆	川菜	1) 主料处理：土豆切条/片，加少许盐与油拌匀，腌10分钟；辅料如木耳/笋/胡萝卜按需切条。\n2) 调鱼香汁：生抽2、老抽1/2、米醋2、白糖3、郫县豆瓣1、蒜姜末各适量、清水与淀粉调稀。\n3) 锅中少油，下豆瓣小火炒红油，入蒜姜与泡椒末炒香。\n4) 下土豆大火快炒至变色，加入辅料翻匀。\n5) 沿锅边倒入鱼香汁，翻炒至汤汁浓亮、均匀裹附，出锅。
鱼香藕片	川菜	1) 主料处理：藕片切条/片，加少许盐与油拌匀，腌10分钟；辅料如木耳/笋/胡萝卜按需切条。\n2) 调鱼香汁：生抽2、老抽1/2、米醋2、白糖3、郫县豆瓣1、蒜姜末各适量、清水与淀粉调稀。\n3) 锅中少油，下豆瓣小火炒红油，入蒜姜与泡椒末炒香。\n4) 下藕片大火快炒至变色，加入辅料翻匀。\n5) 沿锅边倒入鱼香汁，翻炒至汤汁浓亮、均匀裹附，出锅。
鱼香花菜	川菜	1) 主料处理：花菜切条/片，加少许盐与油拌匀，腌10分钟；辅料如木耳/笋/胡萝卜按需切条。\n2) 调鱼香汁：生抽2、老抽1/2、米醋2、白糖3、郫县豆瓣1、蒜姜末各适量、清水与淀粉调稀。\n3) 锅中少油，下豆瓣小火炒红油，入蒜姜与泡椒末炒香。\n4) 下花菜大火快炒至变色，加入辅料翻匀。\n5) 沿锅边倒入鱼香汁，翻炒至汤汁浓亮、均匀裹附，出锅。
鱼香豆皮	川菜	1) 主料处理：豆皮切条/片，加少许盐与油拌匀，腌10分钟；辅料如木耳/笋/胡萝卜按需切条。\n2) 调鱼香汁：生抽2、老抽1/2、米醋2、白糖3、郫县豆瓣1、蒜姜末各适量、清水与淀粉调稀。\n3) 锅中少油，下豆瓣小火炒红油，入蒜姜与泡椒末炒香。\n4) 下豆皮大火快炒至变色，加入辅料翻匀。\n5) 沿锅边倒入鱼香汁，翻炒至汤汁浓亮、均匀裹附，出锅。
鱼香金针菇	川菜	1) 主料处理：金针菇切条/片，加少许盐与油拌匀，腌10分钟；辅料如木耳/笋/胡萝卜按需切条。\n2) 调鱼香汁：生抽2、老抽1/2、米醋2、白糖3、郫县豆瓣1、蒜姜末各适量、清水与淀粉调稀。\n3) 锅中少油，下豆瓣小火炒红油，入蒜姜与泡椒末炒香。\n4) 下金针菇大火快炒至变色，加入辅料翻匀。\n5) 沿锅边倒入鱼香汁，翻炒至汤汁浓亮、均匀裹附，出锅。
鱼香香干	川菜	1) 主料处理：香干切条/片，加少许盐与油拌匀，腌10分钟；辅料如木耳/笋/胡萝卜按需切条。\n2) 调鱼香汁：生抽2、老抽1/2、米醋2、白糖3、郫县豆瓣1、蒜姜末各适量、清水与淀粉调稀。\n3) 锅中少油，下豆瓣小火炒红油，入蒜姜与泡椒末炒香。\n4) 下香干大火快炒至变色，加入辅料翻匀。\n5) 沿锅边倒入鱼香汁，翻炒至汤汁浓亮、均匀裹附，出锅。
鱼香豆芽	川菜	1) 主料处理：豆芽切条/片，加少许盐与油拌匀，腌10分钟；辅料如木耳/笋/胡萝卜按需切条。\n2) 调鱼香汁：生抽2、老抽1/2、米醋2、白糖3、郫县豆瓣1、蒜姜末各适量、清水与淀粉调稀。\n3) 锅中少油，下豆瓣小火炒红油，入蒜姜与泡椒末炒香。\n4) 下豆芽大火快炒至变色，加入辅料翻匀。\n5) 沿锅边倒入鱼香汁，翻炒至汤汁浓亮、均匀裹附，出锅。
鱼香空心菜	川菜	1) 主料处理：空心菜切条/片，加少许盐与油拌匀，腌10分钟；辅料如木耳/笋/胡萝卜按需切条。\n2) 调鱼香汁：生抽2、老抽1/2、米醋2、白糖3、郫县豆瓣1、蒜姜末各适量、清水与淀粉调稀。\n3) 锅中少油，下豆瓣小火炒红油，入蒜姜与泡椒末炒香。\n4) 下空心菜大火快炒至变色，加入辅料翻匀。\n5) 沿锅边倒入鱼香汁，翻炒至汤汁浓亮、均匀裹附，出锅。
鱼香莴笋	川菜	1) 主料处理：莴笋切条/片，加少许盐与油拌匀，腌10分钟；辅料如木耳/笋/胡萝卜按需切条。\n2) 调鱼香汁：生抽2、老抽1/2、米醋2、白糖3、郫县豆瓣1、蒜姜末各适量、清水与淀粉调稀。\n3) 锅中少油，下豆瓣小火炒红油，入蒜姜与泡椒末炒香。\n4) 下莴笋大火快炒至变色，加入辅料翻匀。\n5) 沿锅边倒入鱼香汁，翻炒至汤汁浓亮、均匀裹附，出锅。
鱼香木耳	川菜	1) 主料处理：木耳切条/片，加少许盐与油拌匀，腌10分钟；辅料如木耳/笋/胡萝卜按需切条。\n2) 调鱼香汁：生抽2、老抽1/2、米醋2、白糖3、郫县豆瓣1、蒜姜末各适量、清水与淀粉调稀。\n3) 锅中少油，下豆瓣小火炒红油，入蒜姜与泡椒末炒香。\n4) 下木耳大火快炒至变色，加入辅料翻匀。\n5) 沿锅边倒入鱼香汁，翻炒至汤汁浓亮、均匀裹附，出锅。
鱼香杏鲍菇	川菜	1) 主料处理：杏鲍菇切条/片，加少许盐、料酒与淀粉抓匀去腥，腌10分钟；辅料如木耳/笋/胡萝卜按需切条。\n2) 调鱼香汁：生抽2、老抽1/2、米醋2、白糖3、郫县豆瓣1、蒜姜末各适量、清水与淀粉调稀。\n3) 锅中少油，下豆瓣小火炒红油，入蒜姜与泡椒末炒香。\n4) 下杏鲍菇大火快炒至变色，加入辅料翻匀。\n5) 沿锅边倒入鱼香汁，翻炒至汤汁浓亮、均匀裹附，出锅。
鱼香腐竹	川菜	1) 主料处理：腐竹切条/片，加少许盐与油拌匀，腌10分钟；辅料如木耳/笋/胡萝卜按需切条。\n2) 调鱼香汁：生抽2、老抽1/2、米醋2、白糖3、郫县豆瓣1、蒜姜末各适量、清水与淀粉调稀。\n3) 锅中少油，下豆瓣小火炒红油，入蒜姜与泡椒末炒香。\n4) 下腐竹大火快炒至变色，加入辅料翻匀。\n5) 沿锅边倒入鱼香汁，翻炒至汤汁浓亮、均匀裹附，出锅。
麻辣鸡	川菜	1) 鸡切块/段，加少许盐、料酒、胡椒与淀粉抓匀；干辣椒段、花椒粒、蒜片、姜片、葱段备好。\n2) 锅入少许底油，小火炒香花椒与干辣椒，出香不糊。\n3) 下鸡大火翻炒至断生，烹生抽/料酒，少许糖提味。\n4) 继续翻炒至入味，可加少量高汤，收至微干；撒葱段芝麻。
麻辣鸡翅	川菜	1) 鸡翅切块/段，加少许盐、料酒、胡椒与淀粉抓匀；干辣椒段、花椒粒、蒜片、姜片、葱段备好。\n2) 锅入少许底油，小火炒香花椒与干辣椒，出香不糊。\n3) 下鸡翅大火翻炒至断生，烹生抽/料酒，少许糖提味。\n4) 继续翻炒至入味，可加少量高汤，收至微干；撒葱段芝麻。
麻辣鸡爪	川菜	1) 鸡爪切块/段，加少许盐、料酒、胡椒与淀粉抓匀；干辣椒段、花椒粒、蒜片、姜片、葱段备好。\n2) 锅入少许底油，小火炒香花椒与干辣椒，出香不糊。\n3) 下鸡爪大火翻炒至断生，烹生抽/料酒，少许糖提味。\n4) 继续翻炒至入味，可加少量高汤，收至微干；撒葱段芝麻。
麻辣牛肉	川菜	1) 牛肉切块/段，加少许盐、料酒、生抽与淀粉抓匀；干辣椒段、花椒粒、蒜片、姜片、葱段备好。\n2) 锅入少许底油，小火炒香花椒与干辣椒，出香不糊。\n3) 下牛肉大火翻炒至断生，烹生抽/料酒，少许糖提味。\n4) 继续翻炒至入味，可加少量高汤，收至微干；撒葱段芝麻。
麻辣猪肉	川菜	1) 猪肉切块/段，加少许盐、料酒、生抽与淀粉抓匀；干辣椒段、花椒粒、蒜片、姜片、葱段备好。\n2) 锅入少许底油，小火炒香花椒与干辣椒，出香不糊。\n3) 下猪肉大火翻炒至断生，烹生抽/料酒，少许糖提味。\n4) 继续翻炒至入味，可加少量高汤，收至微干；撒葱段芝麻。
麻辣排骨	川菜	1) 排骨切块/段，加少许盐与油拌匀；干辣椒段、花椒粒、蒜片、姜片、葱段备好。\n2) 锅入少许底油，小火炒香花椒与干辣椒，出香不糊。\n3) 下排骨大火翻炒至断生，烹生抽/料酒，少许糖提味。\n4) 继续翻炒至入味，可加少量高汤，收至微干；撒葱段芝麻。
麻辣虾	川菜	1) 虾切块/段，加少许盐、料酒与淀粉抓匀去腥；干辣椒段、花椒粒、蒜片、姜片、葱段备好。\n2) 锅入少许底油，小火炒香花椒与干辣椒，出香不糊。\n3) 下虾大火翻炒至断生，烹生抽/料酒，少许糖提味。\n4) 继续翻炒至入味，可加少量高汤，收至微干；撒葱段芝麻。
麻辣虾仁	川菜	1) 虾仁切块/段，加少许盐、料酒与淀粉抓匀去腥；干辣椒段、花椒粒、蒜片、姜片、葱段备好。\n2) 锅入少许底油，小火炒香花椒与干辣椒，出香不糊。\n3) 下虾仁大火翻炒至断生，烹生抽/料酒，少许糖提味。\n4) 继续翻炒至入味，可加少量高汤，收至微干；撒葱段芝麻。
麻辣腰花	川菜	1) 腰花切块/段，加少许盐与油拌匀；干辣椒段、花椒粒、蒜片、姜片、葱段备好。\n2) 锅入少许底油，小火炒香花椒与干辣椒，出香不糊。\n3) 下腰花大火翻炒至断生，烹生抽/料酒，少许糖提味。\n4) 继续翻炒至入味，可加少量高汤，收至微干；撒葱段芝麻。
麻辣肥肠	川菜	1) 肥肠切块/段，加少许盐、料酒、生抽与淀粉抓匀；干辣椒段、花椒粒、蒜片、姜片、葱段备好。\n2) 锅入少许底油，小火炒香花椒与干辣椒，出香不糊。\n3) 下肥肠大火翻炒至断生，烹生抽/料酒，少许糖提味。\n4) 继续翻炒至入味，可加少量高汤，收至微干；撒葱段芝麻。
麻辣牛蛙	川菜	1) 牛蛙切块/段，加少许盐、料酒、生抽与淀粉抓匀；干辣椒段、花椒粒、蒜片、姜片、葱段备好。\n2) 锅入少许底油，小火炒香花椒与干辣椒，出香不糊。\n3) 下牛蛙大火翻炒至断生，烹生抽/料酒，少许糖提味。\n4) 继续翻炒至入味，可加少量高汤，收至微干；撒葱段芝麻。
麻辣鸭	川菜	1) 鸭切块/段，加少许盐、料酒、胡椒与淀粉抓匀；干辣椒段、花椒粒、蒜片、姜片、葱段备好。\n2) 锅入少许底油，小火炒香花椒与干辣椒，出香不糊。\n3) 下鸭大火翻炒至断生，烹生抽/料酒，少许糖提味。\n4) 继续翻炒至入味，可加少量高汤，收至微干；撒葱段芝麻。
麻辣鳝鱼	川菜	1) 鳝鱼切块/段，加少许盐、料酒与淀粉抓匀去腥；干辣椒段、花椒粒、蒜片、姜片、葱段备好。\n2) 锅入少许底油，小火炒香花椒与干辣椒，出香不糊。\n3) 下鳝鱼大火翻炒至断生，烹生抽/料酒，少许糖提味。\n4) 继续翻炒至入味，可加少量高汤，收至微干；撒葱段芝麻。
麻辣鲈鱼	川菜	1) 鲈鱼切块/段，加少许盐、料酒与淀粉抓匀去腥；干辣椒段、花椒粒、蒜片、姜片、葱段备好。\n2) 锅入少许底油，小火炒香花椒与干辣椒，出香不糊。\n3) 下鲈鱼大火翻炒至断生，烹生抽/料酒，少许糖提味。\n4) 继续翻炒至入味，可加少量高汤，收至微干；撒葱段芝麻。
麻辣草鱼	川菜	1) 草鱼切块/段，加少许盐、料酒与淀粉抓匀去腥；干辣椒段、花椒粒、蒜片、姜片、葱段备好。\n2) 锅入少许底油，小火炒香花椒与干辣椒，出香不糊。\n3) 下草鱼大火翻炒至断生，烹生抽/料酒，少许糖提味。\n4) 继续翻炒至入味，可加少量高汤，收至微干；撒葱段芝麻。
麻辣鲫鱼	川菜	1) 鲫鱼切块/段，加少许盐、料酒与淀粉抓匀去腥；干辣椒段、花椒粒、蒜片、姜片、葱段备好。\n2) 锅入少许底油，小火炒香花椒与干辣椒，出香不糊。\n3) 下鲫鱼大火翻炒至断生，烹生抽/料酒，少许糖提味。\n4) 继续翻炒至入味，可加少量高汤，收至微干；撒葱段芝麻。
麻辣带鱼	川菜	1) 带鱼切块/段，加少许盐、料酒与淀粉抓匀去腥；干辣椒段、花椒粒、蒜片、姜片、葱段备好。\n2) 锅入少许底油，小火炒香花椒与干辣椒，出香不糊。\n3) 下带鱼大火翻炒至断生，烹生抽/料酒，少许糖提味。\n4) 继续翻炒至入味，可加少量高汤，收至微干；撒葱段芝麻。
麻辣茄子	川菜	1) 茄子切块/段，加少许盐与油拌匀；干辣椒段、花椒粒、蒜片、姜片、葱段备好。\n2) 锅入少许底油，小火炒香花椒与干辣椒，出香不糊。\n3) 下茄子大火翻炒至断生，烹生抽/料酒，少许糖提味。\n4) 继续翻炒至入味，可加少量高汤，收至微干；撒葱段芝麻。
麻辣豆腐	川菜	1) 豆腐切块/段，加少许盐与油拌匀；干辣椒段、花椒粒、蒜片、姜片、葱段备好。\n2) 锅入少许底油，小火炒香花椒与干辣椒，出香不糊。\n3) 下豆腐大火翻炒至断生，烹生抽/料酒，少许糖提味。\n4) 继续翻炒至入味，可加少量高汤，收至微干；撒葱段芝麻。
麻辣土豆	川菜	1) 土豆切块/段，加少许盐与油拌匀；干辣椒段、花椒粒、蒜片、姜片、葱段备好。\n2) 锅入少许底油，小火炒香花椒与干辣椒，出香不糊。\n3) 下土豆大火翻炒至断生，烹生抽/料酒，少许糖提味。\n4) 继续翻炒至入味，可加少量高汤，收至微干；撒葱段芝麻。
麻辣藕片	川菜	1) 藕片切块/段，加少许盐与油拌匀；干辣椒段、花椒粒、蒜片、姜片、葱段备好。\n2) 锅入少许底油，小火炒香花椒与干辣椒，出香不糊。\n3) 下藕片大火翻炒至断生，烹生抽/料酒，少许糖提味。\n4) 继续翻炒至入味，可加少量高汤，收至微干；撒葱段芝麻。
麻辣花菜	川菜	1) 花菜切块/段，加少许盐与油拌匀；干辣椒段、花椒粒、蒜片、姜片、葱段备好。\n2) 锅入少许底油，小火炒香花椒与干辣椒，出香不糊。\n3) 下花菜大火翻炒至断生，烹生抽/料酒，少许糖提味。\n4) 继续翻炒至入味，可加少量高汤，收至微干；撒葱段芝麻。
麻辣豆皮	川菜	1) 豆皮切块/段，加少许盐与油拌匀；干辣椒段、花椒粒、蒜片、姜片、葱段备好。\n2) 锅入少许底油，小火炒香花椒与干辣椒，出香不糊。\n3) 下豆皮大火翻炒至断生，烹生抽/料酒，少许糖提味。\n4) 继续翻炒至入味，可加少量高汤，收至微干；撒葱段芝麻。
麻辣金针菇	川菜	1) 金针菇切块/段，加少许盐与油拌匀；干辣椒段、花椒粒、蒜片、姜片、葱段备好。\n2) 锅入少许底油，小火炒香花椒与干辣椒，出香不糊。\n3) 下金针菇大火翻炒至断生，烹生抽/料酒，少许糖提味。\n4) 继续翻炒至入味，可加少量高汤，收至微干；撒葱段芝麻。
麻辣香干	川菜	1) 香干切块/段，加少许盐与油拌匀；干辣椒段、花椒粒、蒜片、姜片、葱段备好。\n2) 锅入少许底油，小火炒香花椒与干辣椒，出香不糊。\n3) 下香干大火翻炒至断生，烹生抽/料酒，少许糖提味。\n4) 继续翻炒至入味，可加少量高汤，收至微干；撒葱段芝麻。
麻辣豆芽	川菜	1) 豆芽切块/段，加少许盐与油拌匀；干辣椒段、花椒粒、蒜片、姜片、葱段备好。\n2) 锅入少许底油，小火炒香花椒与干辣椒，出香不糊。\n3) 下豆芽大火翻炒至断生，烹生抽/料酒，少许糖提味。\n4) 继续翻炒至入味，可加少量高汤，收至微干；撒葱段芝麻。
麻辣空心菜	川菜	1) 空心菜切块/段，加少许盐与油拌匀；干辣椒段、花椒粒、蒜片、姜片、葱段备好。\n2) 锅入少许底油，小火炒香花椒与干辣椒，出香不糊。\n3) 下空心菜大火翻炒至断生，烹生抽/料酒，少许糖提味。\n4) 继续翻炒至入味，可加少量高汤，收至微干；撒葱段芝麻。
麻辣莴笋	川菜	1) 莴笋切块/段，加少许盐与油拌匀；干辣椒段、花椒粒、蒜片、姜片、葱段备好。\n2) 锅入少许底油，小火炒香花椒与干辣椒，出香不糊。\n3) 下莴笋大火翻炒至断生，烹生抽/料酒，少许糖提味。\n4) 继续翻炒至入味，可加少量高汤，收至微干；撒葱段芝麻。
麻辣木耳	川菜	1) 木耳切块/段，加少许盐与油拌匀；干辣椒段、花椒粒、蒜片、姜片、葱段备好。\n2) 锅入少许底油，小火炒香花椒与干辣椒，出香不糊。\n3) 下木耳大火翻炒至断生，烹生抽/料酒，少许糖提味。\n4) 继续翻炒至入味，可加少量高汤，收至微干；撒葱段芝麻。
麻辣杏鲍菇	川菜	1) 杏鲍菇切块/段，加少许盐、料酒与淀粉抓匀去腥；干辣椒段、花椒粒、蒜片、姜片、葱段备好。\n2) 锅入少许底油，小火炒香花椒与干辣椒，出香不糊。\n3) 下杏鲍菇大火翻炒至断生，烹生抽/料酒，少许糖提味。\n4) 继续翻炒至入味，可加少量高汤，收至微干；撒葱段芝麻。
白切鸡	粤菜	1) 三黄鸡冷水下锅，加姜葱与少许盐，小火微沸15~18分钟。\n2) 关火加盖焖10分钟，捞出过冰水至完全冷却，表皮紧致。\n3) 斩块装盘。蘸碟：蒜蓉+姜末+葱花+热油+盐+生抽少许调匀。
清蒸鲈鱼	粤菜	1) 鲈鱼杀洗干净，身斜刀两刀，抹盐少许，鱼腹垫姜丝。\n2) 大火蒸6~8分钟（视大小），出锅倒去蒸汁；铺葱丝姜丝。\n3) 淋热油激香，另起锅烧开蒸鱼豉油，沿边淋上即可。
干炒牛河	粤菜	1) 河粉掰散备用；牛肉逆纹切片，生抽/蚝油/糖/胡椒/淀粉/少油抓匀。\n2) 大火热锅多油，下牛肉快炒至变色盛出。\n3) 锅留油，下蒜片与韭黄、洋葱爆香，入河粉翻炒，调生抽与老抽上色。\n4) 回锅牛肉，快炒均匀，临出锅洒少许葱段。
叉烧	粤菜	1) 梅花肉条腌：叉烧酱/生抽/蚝油/蒜末/糖/蜂蜜/绍酒，冷藏腌过夜。\n2) 烤箱200℃上下火，烤15分钟后刷蜂蜜水，再烤10~15分钟至表面微焦。\n3) 静置5分钟再切片，蘸汁为腌料加热收浓。
豉汁蒸排骨	粤菜	1) 排骨加盐/糖/生抽/蚝油/蒜末/豆豉/胡椒/少许淀粉抓匀腌30分钟。\n2) 高火蒸12~15分钟至软糯入味，出锅撒葱花。
葱油鸡	粤菜	1) 主料走油滑炒或清蒸清炖为主，突出原味。\n2) 调味简洁：盐、胡椒、蒸鱼豉油、葱姜油为主。\n3) 火候准确不过分收汁。
文昌鸡	粤菜	1) 主料走油滑炒或清蒸清炖为主，突出原味。\n2) 调味简洁：盐、胡椒、蒸鱼豉油、葱姜油为主。\n3) 火候准确不过分收汁。
豉油皇炒面	粤菜	1) 主料走油滑炒或清蒸清炖为主，突出原味。\n2) 调味简洁：盐、胡椒、蒸鱼豉油、葱姜油为主。\n3) 火候准确不过分收汁。
咕噜肉	粤菜	1) 里脊块加盐/胡椒/生抽/料酒腌10分钟，拍干粉或裹脆浆。\n2) 下油锅中高火炸至外壳定型捞出，复炸至金脆。\n3) 锅留少油，下番茄酱/白醋/糖/菠萝块/彩椒段调成咕噜汁，回锅肉块快速翻匀。
盐焗鸡	粤菜	1) 主料走油滑炒或清蒸清炖为主，突出原味。\n2) 调味简洁：盐、胡椒、蒸鱼豉油、葱姜油为主。\n3) 火候准确不过分收汁。
豉椒牛河	粤菜	1) 主料走油滑炒或清蒸清炖为主，突出原味。\n2) 调味简洁：盐、胡椒、蒸鱼豉油、葱姜油为主。\n3) 火候准确不过分收汁。
广式烧鸭	粤菜	1) 主料走油滑炒或清蒸清炖为主，突出原味。\n2) 调味简洁：盐、胡椒、蒸鱼豉油、葱姜油为主。\n3) 火候准确不过分收汁。
煲仔饭	粤菜	1) 主料走油滑炒或清蒸清炖为主，突出原味。\n2) 调味简洁：盐、胡椒、蒸鱼豉油、葱姜油为主。\n3) 火候准确不过分收汁。
姜葱炒蟹	粤菜	1) 主料走油滑炒或清蒸清炖为主，突出原味。\n2) 调味简洁：盐、胡椒、蒸鱼豉油、葱姜油为主。\n3) 火候准确不过分收汁。
白灼虾	粤菜	1) 主料走油滑炒或清蒸清炖为主，突出原味。\n2) 调味简洁：盐、胡椒、蒸鱼豉油、葱姜油为主。\n3) 火候准确不过分收汁。
瑶柱蛋白炒饭	粤菜	1) 主料走油滑炒或清蒸清炖为主，突出原味。\n2) 调味简洁：盐、胡椒、蒸鱼豉油、葱姜油为主。\n3) 火候准确不过分收汁。
艇仔粥	粤菜	1) 主料走油滑炒或清蒸清炖为主，突出原味。\n2) 调味简洁：盐、胡椒、蒸鱼豉油、葱姜油为主。\n3) 火候准确不过分收汁。
腊味合蒸	粤菜	1) 主料走油滑炒或清蒸清炖为主，突出原味。\n2) 调味简洁：盐、胡椒、蒸鱼豉油、葱姜油为主。\n3) 火候准确不过分收汁。
上汤浸时蔬	粤菜	1) 主料走油滑炒或清蒸清炖为主，突出原味。\n2) 调味简洁：盐、胡椒、蒸鱼豉油、葱姜油为主。\n3) 火候准确不过分收汁。
咸蛋蒸肉饼	粤菜	1) 主料走油滑炒或清蒸清炖为主，突出原味。\n2) 调味简洁：盐、胡椒、蒸鱼豉油、葱姜油为主。\n3) 火候准确不过分收汁。
广式早茶虾饺	粤菜	1) 主料走油滑炒或清蒸清炖为主，突出原味。\n2) 调味简洁：盐、胡椒、蒸鱼豉油、葱姜油为主。\n3) 火候准确不过分收汁。
肠粉	粤菜	1) 主料走油滑炒或清蒸清炖为主，突出原味。\n2) 调味简洁：盐、胡椒、蒸鱼豉油、葱姜油为主。\n3) 火候准确不过分收汁。
马拉糕	粤菜	1) 主料走油滑炒或清蒸清炖为主，突出原味。\n2) 调味简洁：盐、胡椒、蒸鱼豉油、葱姜油为主。\n3) 火候准确不过分收汁。
糯米鸡	粤菜	1) 主料走油滑炒或清蒸清炖为主，突出原味。\n2) 调味简洁：盐、胡椒、蒸鱼豉油、葱姜油为主。\n3) 火候准确不过分收汁。
凤爪	粤菜	1) 主料走油滑炒或清蒸清炖为主，突出原味。\n2) 调味简洁：盐、胡椒、蒸鱼豉油、葱姜油为主。\n3) 火候准确不过分收汁。
蜜汁叉烧	粤菜	1) 主料走油滑炒或清蒸清炖为主，突出原味。\n2) 调味简洁：盐、胡椒、蒸鱼豉油、葱姜油为主。\n3) 火候准确不过分收汁。
柱侯牛腩	粤菜	1) 主料走油滑炒或清蒸清炖为主，突出原味。\n2) 调味简洁：盐、胡椒、蒸鱼豉油、葱姜油为主。\n3) 火候准确不过分收汁。
河粉牛腩	粤菜	1) 主料走油滑炒或清蒸清炖为主，突出原味。\n2) 调味简洁：盐、胡椒、蒸鱼豉油、葱姜油为主。\n3) 火候准确不过分收汁。
豉油鸡	粤菜	1) 主料走油滑炒或清蒸清炖为主，突出原味。\n2) 调味简洁：盐、胡椒、蒸鱼豉油、葱姜油为主。\n3) 火候准确不过分收汁。
沙姜鸡	粤菜	1) 主料走油滑炒或清蒸清炖为主，突出原味。\n2) 调味简洁：盐、胡椒、蒸鱼豉油、葱姜油为主。\n3) 火候准确不过分收汁。
白切鹅	粤菜	1) 鹅冷水入锅，加姜葱与盐，小火微沸至熟（禽类15~20分钟，肉类视情况）。\n2) 出锅过冰水至冷却后切件；蘸碟：姜葱蒜末+热油+盐+生抽少许。
白切鸭	粤菜	1) 鸭冷水入锅，加姜葱与盐，小火微沸至熟（禽类15~20分钟，肉类视情况）。\n2) 出锅过冰水至冷却后切件；蘸碟：姜葱蒜末+热油+盐+生抽少许。
白切鸡脚	粤菜	1) 鸡脚冷水入锅，加姜葱与盐，小火微沸至熟（禽类15~20分钟，肉类视情况）。\n2) 出锅过冰水至冷却后切件；蘸碟：姜葱蒜末+热油+盐+生抽少许。
白切猪肘	粤菜	1) 猪肘冷水入锅，加姜葱与盐，小火微沸至熟（禽类15~20分钟，肉类视情况）。\n2) 出锅过冰水至冷却后切件；蘸碟：姜葱蒜末+热油+盐+生抽少许。
白切叉烧	粤菜	1) 叉烧冷水入锅，加姜葱与盐，小火微沸至熟（禽类15~20分钟，肉类视情况）。\n2) 出锅过冰水至冷却后切件；蘸碟：姜葱蒜末+热油+盐+生抽少许。
白切排骨	粤菜	1) 排骨冷水入锅，加姜葱与盐，小火微沸至熟（禽类15~20分钟，肉类视情况）。\n2) 出锅过冰水至冷却后切件；蘸碟：姜葱蒜末+热油+盐+生抽少许。
白切牛腩	粤菜	1) 牛腩冷水入锅，加姜葱与盐，小火微沸至熟（禽类15~20分钟，肉类视情况）。\n2) 出锅过冰水至冷却后切件；蘸碟：姜葱蒜末+热油+盐+生抽少许。
白切牛肉	粤菜	1) 牛肉冷水入锅，加姜葱与盐，小火微沸至熟（禽类15~20分钟，肉类视情况）。\n2) 出锅过冰水至冷却后切件；蘸碟：姜葱蒜末+热油+盐+生抽少许。
白切虾	粤菜	1) 虾冷水入锅，加姜葱与盐，小火微沸至熟（禽类15~20分钟，肉类视情况）。\n2) 出锅过冰水至冷却后切件；蘸碟：姜葱蒜末+热油+盐+生抽少许。
白切虾仁	粤菜	1) 虾仁冷水入锅，加姜葱与盐，小火微沸至熟（禽类15~20分钟，肉类视情况）。\n2) 出锅过冰水至冷却后切件；蘸碟：姜葱蒜末+热油+盐+生抽少许。
白切带子	粤菜	1) 带子冷水入锅，加姜葱与盐，小火微沸至熟（禽类15~20分钟，肉类视情况）。\n2) 出锅过冰水至冷却后切件；蘸碟：姜葱蒜末+热油+盐+生抽少许。
白切鲈鱼	粤菜	1) 鲈鱼冷水入锅，加姜葱与盐，小火微沸至熟（禽类15~20分钟，肉类视情况）。\n2) 出锅过冰水至冷却后切件；蘸碟：姜葱蒜末+热油+盐+生抽少许。
白切石斑	粤菜	1) 石斑冷水入锅，加姜葱与盐，小火微沸至熟（禽类15~20分钟，肉类视情况）。\n2) 出锅过冰水至冷却后切件；蘸碟：姜葱蒜末+热油+盐+生抽少许。
白切鲳鱼	粤菜	1) 鲳鱼冷水入锅，加姜葱与盐，小火微沸至熟（禽类15~20分钟，肉类视情况）。\n2) 出锅过冰水至冷却后切件；蘸碟：姜葱蒜末+热油+盐+生抽少许。
白切青口	粤菜	1) 青口冷水入锅，加姜葱与盐，小火微沸至熟（禽类15~20分钟，肉类视情况）。\n2) 出锅过冰水至冷却后切件；蘸碟：姜葱蒜末+热油+盐+生抽少许。
白切象拔蚌	粤菜	1) 象拔蚌冷水入锅，加姜葱与盐，小火微沸至熟（禽类15~20分钟，肉类视情况）。\n2) 出锅过冰水至冷却后切件；蘸碟：姜葱蒜末+热油+盐+生抽少许。
白切生菜	粤菜	1) 生菜冷水入锅，加姜葱与盐，小火微沸至熟（禽类15~20分钟，肉类视情况）。\n2) 出锅过冰水至冷却后切件；蘸碟：姜葱蒜末+热油+盐+生抽少许。
白切菜心	粤菜	1) 菜心冷水入锅，加姜葱与盐，小火微沸至熟（禽类15~20分钟，肉类视情况）。\n2) 出锅过冰水至冷却后切件；蘸碟：姜葱蒜末+热油+盐+生抽少许。
白切芥兰	粤菜	1) 芥兰冷水入锅，加姜葱与盐，小火微沸至熟（禽类15~20分钟，肉类视情况）。\n2) 出锅过冰水至冷却后切件；蘸碟：姜葱蒜末+热油+盐+生抽少许。
白切豆苗	粤菜	1) 豆苗冷水入锅，加姜葱与盐，小火微沸至熟（禽类15~20分钟，肉类视情况）。\n2) 出锅过冰水至冷却后切件；蘸碟：姜葱蒜末+热油+盐+生抽少许。
白切腐竹	粤菜	1) 腐竹冷水入锅，加姜葱与盐，小火微沸至熟（禽类15~20分钟，肉类视情况）。\n2) 出锅过冰水至冷却后切件；蘸碟：姜葱蒜末+热油+盐+生抽少许。
白切香芋	粤菜	1) 香芋冷水入锅，加姜葱与盐，小火微沸至熟（禽类15~20分钟，肉类视情况）。\n2) 出锅过冰水至冷却后切件；蘸碟：姜葱蒜末+热油+盐+生抽少许。
白切腊味	粤菜	1) 腊味冷水入锅，加姜葱与盐，小火微沸至熟（禽类15~20分钟，肉类视情况）。\n2) 出锅过冰水至冷却后切件；蘸碟：姜葱蒜末+热油+盐+生抽少许。
白切腊肠	粤菜	1) 腊肠冷水入锅，加姜葱与盐，小火微沸至熟（禽类15~20分钟，肉类视情况）。\n2) 出锅过冰水至冷却后切件；蘸碟：姜葱蒜末+热油+盐+生抽少许。
白切莲藕	粤菜	1) 莲藕冷水入锅，加姜葱与盐，小火微沸至熟（禽类15~20分钟，肉类视情况）。\n2) 出锅过冰水至冷却后切件；蘸碟：姜葱蒜末+热油+盐+生抽少许。
白切冬瓜	粤菜	1) 冬瓜冷水入锅，加姜葱与盐，小火微沸至熟（禽类15~20分钟，肉类视情况）。\n2) 出锅过冰水至冷却后切件；蘸碟：姜葱蒜末+热油+盐+生抽少许。
清蒸鸡	粤菜	1) 鸡处理干净，抹盐，垫姜丝葱段。\n2) 大火蒸熟（鱼类6~8分钟、贝类3~5分钟、肉类10~15分钟）。\n3) 倒去蒸汁，铺葱丝淋热油，配蒸鱼豉油。
清蒸鹅	粤菜	1) 鹅处理干净，抹盐，垫姜丝葱段。\n2) 大火蒸熟（鱼类6~8分钟、贝类3~5分钟、肉类10~15分钟）。\n3) 倒去蒸汁，铺葱丝淋热油，配蒸鱼豉油。
清蒸鸭	粤菜	1) 鸭处理干净，抹盐，垫姜丝葱段。\n2) 大火蒸熟（鱼类6~8分钟、贝类3~5分钟、肉类10~15分钟）。\n3) 倒去蒸汁，铺葱丝淋热油，配蒸鱼豉油。
清蒸鸡脚	粤菜	1) 鸡脚处理干净，抹盐，垫姜丝葱段。\n2) 大火蒸熟（鱼类6~8分钟、贝类3~5分钟、肉类10~15分钟）。\n3) 倒去蒸汁，铺葱丝淋热油，配蒸鱼豉油。
清蒸猪肘	粤菜	1) 猪肘处理干净，抹盐，垫姜丝葱段。\n2) 大火蒸熟（鱼类6~8分钟、贝类3~5分钟、肉类10~15分钟）。\n3) 倒去蒸汁，铺葱丝淋热油，配蒸鱼豉油。
清蒸叉烧	粤菜	1) 叉烧处理干净，抹盐，垫姜丝葱段。\n2) 大火蒸熟（鱼类6~8分钟、贝类3~5分钟、肉类10~15分钟）。\n3) 倒去蒸汁，铺葱丝淋热油，配蒸鱼豉油。
清蒸排骨	粤菜	1) 排骨处理干净，抹盐，垫姜丝葱段。\n2) 大火蒸熟（鱼类6~8分钟、贝类3~5分钟、肉类10~15分钟）。\n3) 倒去蒸汁，铺葱丝淋热油，配蒸鱼豉油。
清蒸牛腩	粤菜	1) 牛腩处理干净，抹盐，垫姜丝葱段。\n2) 大火蒸熟（鱼类6~8分钟、贝类3~5分钟、肉类10~15分钟）。\n3) 倒去蒸汁，铺葱丝淋热油，配蒸鱼豉油。
清蒸牛肉	粤菜	1) 牛肉处理干净，抹盐，垫姜丝葱段。\n2) 大火蒸熟（鱼类6~8分钟、贝类3~5分钟、肉类10~15分钟）。\n3) 倒去蒸汁，铺葱丝淋热油，配蒸鱼豉油。
清蒸虾	粤菜	1) 虾处理干净，抹盐，垫姜丝葱段。\n2) 大火蒸熟（鱼类6~8分钟、贝类3~5分钟、肉类10~15分钟）。\n3) 倒去蒸汁，铺葱丝淋热油，配蒸鱼豉油。
清蒸虾仁	粤菜	1) 虾仁处理干净，抹盐，垫姜丝葱段。\n2) 大火蒸熟（鱼类6~8分钟、贝类3~5分钟、肉类10~15分钟）。\n3) 倒去蒸汁，铺葱丝淋热油，配蒸鱼豉油。
清蒸带子	粤菜	1) 带子处理干净，抹盐，垫姜丝葱段。\n2) 大火蒸熟（鱼类6~8分钟、贝类3~5分钟、肉类10~15分钟）。\n3) 倒去蒸汁，铺葱丝淋热油，配蒸鱼豉油。
清蒸石斑	粤菜	1) 石斑处理干净，抹盐，垫姜丝葱段。\n2) 大火蒸熟（鱼类6~8分钟、贝类3~5分钟、肉类10~15分钟）。\n3) 倒去蒸汁，铺葱丝淋热油，配蒸鱼豉油。
清蒸鲳鱼	粤菜	1) 鲳鱼处理干净，抹盐，垫姜丝葱段。\n2) 大火蒸熟（鱼类6~8分钟、贝类3~5分钟、肉类10~15分钟）。\n3) 倒去蒸汁，铺葱丝淋热油，配蒸鱼豉油。
清蒸青口	粤菜	1) 青口处理干净，抹盐，垫姜丝葱段。\n2) 大火蒸熟（鱼类6~8分钟、贝类3~5分钟、肉类10~15分钟）。\n3) 倒去蒸汁，铺葱丝淋热油，配蒸鱼豉油。
清蒸象拔蚌	粤菜	1) 象拔蚌处理干净，抹盐，垫姜丝葱段。\n2) 大火蒸熟（鱼类6~8分钟、贝类3~5分钟、肉类10~15分钟）。\n3) 倒去蒸汁，铺葱丝淋热油，配蒸鱼豉油。
清蒸生菜	粤菜	1) 生菜处理干净，抹盐，垫姜丝葱段。\n2) 大火蒸熟（鱼类6~8分钟、贝类3~5分钟、肉类10~15分钟）。\n3) 倒去蒸汁，铺葱丝淋热油，配蒸鱼豉油。
清蒸菜心	粤菜	1) 菜心处理干净，抹盐，垫姜丝葱段。\n2) 大火蒸熟（鱼类6~8分钟、贝类3~5分钟、肉类10~15分钟）。\n3) 倒去蒸汁，铺葱丝淋热油，配蒸鱼豉油。
清蒸芥兰	粤菜	1) 芥兰处理干净，抹盐，垫姜丝葱段。\n2) 大火蒸熟（鱼类6~8分钟、贝类3~5分钟、肉类10~15分钟）。\n3) 倒去蒸汁，铺葱丝淋热油，配蒸鱼豉油。
清蒸豆苗	粤菜	1) 豆苗处理干净，抹盐，垫姜丝葱段。\n2) 大火蒸熟（鱼类6~8分钟、贝类3~5分钟、肉类10~15分钟）。\n3) 倒去蒸汁，铺葱丝淋热油，配蒸鱼豉油。
清蒸腐竹	粤菜	1) 腐竹处理干净，抹盐，垫姜丝葱段。\n2) 大火蒸熟（鱼类6~8分钟、贝类3~5分钟、肉类10~15分钟）。\n3) 倒去蒸汁，铺葱丝淋热油，配蒸鱼豉油。
清蒸香芋	粤菜	1) 香芋处理干净，抹盐，垫姜丝葱段。\n2) 大火蒸熟（鱼类6~8分钟、贝类3~5分钟、肉类10~15分钟）。\n3) 倒去蒸汁，铺葱丝淋热油，配蒸鱼豉油。
清蒸腊味	粤菜	1) 腊味处理干净，抹盐，垫姜丝葱段。\n2) 大火蒸熟（鱼类6~8分钟、贝类3~5分钟、肉类10~15分钟）。\n3) 倒去蒸汁，铺葱丝淋热油，配蒸鱼豉油。
清蒸腊肠	粤菜	1) 腊肠处理干净，抹盐，垫姜丝葱段。\n2) 大火蒸熟（鱼类6~8分钟、贝类3~5分钟、肉类10~15分钟）。\n3) 倒去蒸汁，铺葱丝淋热油，配蒸鱼豉油。
清蒸莲藕	粤菜	1) 莲藕处理干净，抹盐，垫姜丝葱段。\n2) 大火蒸熟（鱼类6~8分钟、贝类3~5分钟、肉类10~15分钟）。\n3) 倒去蒸汁，铺葱丝淋热油，配蒸鱼豉油。
清蒸冬瓜	粤菜	1) 冬瓜处理干净，抹盐，垫姜丝葱段。\n2) 大火蒸熟（鱼类6~8分钟、贝类3~5分钟、肉类10~15分钟）。\n3) 倒去蒸汁，铺葱丝淋热油，配蒸鱼豉油。
避风塘鸡	粤菜	1) 鸡裹生粉炸至金黄酥脆备用；蒜蓉、面包糠/麦片、椒盐备好。\n2) 锅少油中小火炒蒜蓉至金黄，入面包糠与椒盐炒香。\n3) 回投主料快速翻匀，离火保持干香酥脆。
避风塘鹅	粤菜	1) 鹅裹生粉炸至金黄酥脆备用；蒜蓉、面包糠/麦片、椒盐备好。\n2) 锅少油中小火炒蒜蓉至金黄，入面包糠与椒盐炒香。\n3) 回投主料快速翻匀，离火保持干香酥脆。
避风塘鸭	粤菜	1) 鸭裹生粉炸至金黄酥脆备用；蒜蓉、面包糠/麦片、椒盐备好。\n2) 锅少油中小火炒蒜蓉至金黄，入面包糠与椒盐炒香。\n3) 回投主料快速翻匀，离火保持干香酥脆。
避风塘鸡脚	粤菜	1) 鸡脚裹生粉炸至金黄酥脆备用；蒜蓉、面包糠/麦片、椒盐备好。\n2) 锅少油中小火炒蒜蓉至金黄，入面包糠与椒盐炒香。\n3) 回投主料快速翻匀，离火保持干香酥脆。
避风塘猪肘	粤菜	1) 猪肘裹生粉炸至金黄酥脆备用；蒜蓉、面包糠/麦片、椒盐备好。\n2) 锅少油中小火炒蒜蓉至金黄，入面包糠与椒盐炒香。\n3) 回投主料快速翻匀，离火保持干香酥脆。
避风塘叉烧	粤菜	1) 叉烧裹生粉炸至金黄酥脆备用；蒜蓉、面包糠/麦片、椒盐备好。\n2) 锅少油中小火炒蒜蓉至金黄，入面包糠与椒盐炒香。\n3) 回投主料快速翻匀，离火保持干香酥脆。
避风塘排骨	粤菜	1) 排骨裹生粉炸至金黄酥脆备用；蒜蓉、面包糠/麦片、椒盐备好。\n2) 锅少油中小火炒蒜蓉至金黄，入面包糠与椒盐炒香。\n3) 回投主料快速翻匀，离火保持干香酥脆。
避风塘牛腩	粤菜	1) 牛腩裹生粉炸至金黄酥脆备用；蒜蓉、面包糠/麦片、椒盐备好。\n2) 锅少油中小火炒蒜蓉至金黄，入面包糠与椒盐炒香。\n3) 回投主料快速翻匀，离火保持干香酥脆。
避风塘牛肉	粤菜	1) 牛肉裹生粉炸至金黄酥脆备用；蒜蓉、面包糠/麦片、椒盐备好。\n2) 锅少油中小火炒蒜蓉至金黄，入面包糠与椒盐炒香。\n3) 回投主料快速翻匀，离火保持干香酥脆。
避风塘虾	粤菜	1) 虾裹生粉炸至金黄酥脆备用；蒜蓉、面包糠/麦片、椒盐备好。\n2) 锅少油中小火炒蒜蓉至金黄，入面包糠与椒盐炒香。\n3) 回投主料快速翻匀，离火保持干香酥脆。
避风塘虾仁	粤菜	1) 虾仁裹生粉炸至金黄酥脆备用；蒜蓉、面包糠/麦片、椒盐备好。\n2) 锅少油中小火炒蒜蓉至金黄，入面包糠与椒盐炒香。\n3) 回投主料快速翻匀，离火保持干香酥脆。
避风塘带子	粤菜	1) 带子裹生粉炸至金黄酥脆备用；蒜蓉、面包糠/麦片、椒盐备好。\n2) 锅少油中小火炒蒜蓉至金黄，入面包糠与椒盐炒香。\n3) 回投主料快速翻匀，离火保持干香酥脆。
避风塘鲈鱼	粤菜	1) 鲈鱼裹生粉炸至金黄酥脆备用；蒜蓉、面包糠/麦片、椒盐备好。\n2) 锅少油中小火炒蒜蓉至金黄，入面包糠与椒盐炒香。\n3) 回投主料快速翻匀，离火保持干香酥脆。
避风塘石斑	粤菜	1) 石斑裹生粉炸至金黄酥脆备用；蒜蓉、面包糠/麦片、椒盐备好。\n2) 锅少油中小火炒蒜蓉至金黄，入面包糠与椒盐炒香。\n3) 回投主料快速翻匀，离火保持干香酥脆。
避风塘鲳鱼	粤菜	1) 鲳鱼裹生粉炸至金黄酥脆备用；蒜蓉、面包糠/麦片、椒盐备好。\n2) 锅少油中小火炒蒜蓉至金黄，入面包糠与椒盐炒香。\n3) 回投主料快速翻匀，离火保持干香酥脆。
避风塘青口	粤菜	1) 青口裹生粉炸至金黄酥脆备用；蒜蓉、面包糠/麦片、椒盐备好。\n2) 锅少油中小火炒蒜蓉至金黄，入面包糠与椒盐炒香。\n3) 回投主料快速翻匀，离火保持干香酥脆。
避风塘象拔蚌	粤菜	1) 象拔蚌裹生粉炸至金黄酥脆备用；蒜蓉、面包糠/麦片、椒盐备好。\n2) 锅少油中小火炒蒜蓉至金黄，入面包糠与椒盐炒香。\n3) 回投主料快速翻匀，离火保持干香酥脆。
避风塘生菜	粤菜	1) 生菜裹生粉炸至金黄酥脆备用；蒜蓉、面包糠/麦片、椒盐备好。\n2) 锅少油中小火炒蒜蓉至金黄，入面包糠与椒盐炒香。\n3) 回投主料快速翻匀，离火保持干香酥脆。
松鼠桂鱼	苏菜	1) 桂鱼去骨去刺保留尾，鱼身打十字花刀并擦干。\n2) 先挂薄层干粉，下180℃油温炸至定型，再升至200℃复炸至金黄。\n3) 另起锅：糖醋汁（番茄酱/糖/醋/少许盐/清水/淀粉），煮至透亮。\n4) 鱼摆盘成松鼠状，淋上糖醋汁，撒松仁/青豆点缀。
红烧狮子头	苏菜	1) 狮子头焯水或腌制备用；炒糖色至琥珀，下主料上色。\n2) 加生抽/老抽/黄酒/姜葱与热水，小火焖至软烂。\n3) 大火收汁至浓亮，口味微甜咸香。
清炖蟹粉狮子头	苏菜	1) 砂锅放蟹粉狮子头与姜葱、少许料酒，倒入清水或高汤。\n2) 小火慢炖至软烂清鲜，调盐即可；强调汤清味醇，不重色。
扬州炒饭	苏菜	1) 注重刀工与火候，口味偏甜咸适中。\n2) 爆炒/红烧/清炖皆可，汤汁多清亮或糖醋透亮。\n3) 勾薄芡保持清爽不腻。
三套鸭	苏菜	1) 注重刀工与火候，口味偏甜咸适中。\n2) 爆炒/红烧/清炖皆可，汤汁多清亮或糖醋透亮。\n3) 勾薄芡保持清爽不腻。
平桥豆腐	苏菜	1) 注重刀工与火候，口味偏甜咸适中。\n2) 爆炒/红烧/清炖皆可，汤汁多清亮或糖醋透亮。\n3) 勾薄芡保持清爽不腻。
盐水鸭	苏菜	1) 注重刀工与火候，口味偏甜咸适中。\n2) 爆炒/红烧/清炖皆可，汤汁多清亮或糖醋透亮。\n3) 勾薄芡保持清爽不腻。
糖醋小排	苏菜	1) 小排处理后干煎/炸至定型；\n2) 调糖醋汁（糖:醋≈2:1，酱油少许、清水与淀粉），入锅煮至透亮；\n3) 回锅裹匀翻炒，酸甜开胃。
清汤火方	苏菜	1) 上好清汤与火方同煮，小火保持清亮不混；\n2) 以盐与胡椒轻调味，突出本味。
蟹粉豆腐	苏菜	1) 蟹黄/蟹粉与葱姜爆香，加黄酒与高汤略熬；\n2) 下豆腐（或提前处理好的丸子/豆腐/小排等），微火煨入味；\n3) 以盐/糖调味，勾薄芡，淋上猪油或鸡油提香。
大煮干丝	苏菜	1) 注重刀工与火候，口味偏甜咸适中。\n2) 爆炒/红烧/清炖皆可，汤汁多清亮或糖醋透亮。\n3) 勾薄芡保持清爽不腻。
清炖甲鱼	苏菜	1) 砂锅放甲鱼与姜葱、少许料酒，倒入清水或高汤。\n2) 小火慢炖至软烂清鲜，调盐即可；强调汤清味醇，不重色。
桂花糖芋艿	苏菜	1) 注重刀工与火候，口味偏甜咸适中。\n2) 爆炒/红烧/清炖皆可，汤汁多清亮或糖醋透亮。\n3) 勾薄芡保持清爽不腻。
清炖鸡孚	苏菜	1) 砂锅放鸡孚与姜葱、少许料酒，倒入清水或高汤。\n2) 小火慢炖至软烂清鲜，调盐即可；强调汤清味醇，不重色。
清炖河鳗	苏菜	1) 砂锅放河鳗与姜葱、少许料酒，倒入清水或高汤。\n2) 小火慢炖至软烂清鲜，调盐即可；强调汤清味醇，不重色。
文思豆腐	苏菜	1) 注重刀工与火候，口味偏甜咸适中。\n2) 爆炒/红烧/清炖皆可，汤汁多清亮或糖醋透亮。\n3) 勾薄芡保持清爽不腻。
清汤越鸡	苏菜	1) 上好清汤与越鸡同煮，小火保持清亮不混；\n2) 以盐与胡椒轻调味，突出本味。
阳春面	苏菜	1) 注重刀工与火候，口味偏甜咸适中。\n2) 爆炒/红烧/清炖皆可，汤汁多清亮或糖醋透亮。\n3) 勾薄芡保持清爽不腻。
香菇菜心	苏菜	1) 注重刀工与火候，口味偏甜咸适中。\n2) 爆炒/红烧/清炖皆可，汤汁多清亮或糖醋透亮。\n3) 勾薄芡保持清爽不腻。
清炖河虾	苏菜	1) 砂锅放河虾与姜葱、少许料酒，倒入清水或高汤。\n2) 小火慢炖至软烂清鲜，调盐即可；强调汤清味醇，不重色。
松鼠狮子头	苏菜	1) 狮子头打花刀擦干，挂薄粉入油锅炸至金黄，复炸更酥；\n2) 糖醋番茄汁煮至透亮；\n3) 摆形后淋汁，脆皮裹酸甜。
松鼠小排	苏菜	1) 小排打花刀擦干，挂薄粉入油锅炸至金黄，复炸更酥；\n2) 糖醋番茄汁煮至透亮；\n3) 摆形后淋汁，脆皮裹酸甜。
松鼠河鳗	苏菜	1) 河鳗打花刀擦干，挂薄粉入油锅炸至金黄，复炸更酥；\n2) 糖醋番茄汁煮至透亮；\n3) 摆形后淋汁，脆皮裹酸甜。
松鼠甲鱼	苏菜	1) 甲鱼打花刀擦干，挂薄粉入油锅炸至金黄，复炸更酥；\n2) 糖醋番茄汁煮至透亮；\n3) 摆形后淋汁，脆皮裹酸甜。
松鼠鸭	苏菜	1) 鸭打花刀擦干，挂薄粉入油锅炸至金黄，复炸更酥；\n2) 糖醋番茄汁煮至透亮；\n3) 摆形后淋汁，脆皮裹酸甜。
松鼠鸡	苏菜	1) 鸡打花刀擦干，挂薄粉入油锅炸至金黄，复炸更酥；\n2) 糖醋番茄汁煮至透亮；\n3) 摆形后淋汁，脆皮裹酸甜。
松鼠虾仁	苏菜	1) 虾仁打花刀擦干，挂薄粉入油锅炸至金黄，复炸更酥；\n2) 糖醋番茄汁煮至透亮；\n3) 摆形后淋汁，脆皮裹酸甜。
松鼠大闸蟹	苏菜	1) 大闸蟹打花刀擦干，挂薄粉入油锅炸至金黄，复炸更酥；\n2) 糖醋番茄汁煮至透亮；\n3) 摆形后淋汁，脆皮裹酸甜。
松鼠银鱼	苏菜	1) 银鱼打花刀擦干，挂薄粉入油锅炸至金黄，复炸更酥；\n2) 糖醋番茄汁煮至透亮；\n3) 摆形后淋汁，脆皮裹酸甜。
松鼠河虾	苏菜	1) 河虾打花刀擦干，挂薄粉入油锅炸至金黄，复炸更酥；\n2) 糖醋番茄汁煮至透亮；\n3) 摆形后淋汁，脆皮裹酸甜。
松鼠鳝丝	苏菜	1) 鳝丝打花刀擦干，挂薄粉入油锅炸至金黄，复炸更酥；\n2) 糖醋番茄汁煮至透亮；\n3) 摆形后淋汁，脆皮裹酸甜。
松鼠笋	苏菜	1) 笋打花刀擦干，挂薄粉入油锅炸至金黄，复炸更酥；\n2) 糖醋番茄汁煮至透亮；\n3) 摆形后淋汁，脆皮裹酸甜。
松鼠冬瓜	苏菜	1) 冬瓜打花刀擦干，挂薄粉入油锅炸至金黄，复炸更酥；\n2) 糖醋番茄汁煮至透亮；\n3) 摆形后淋汁，脆皮裹酸甜。
松鼠藕	苏菜	1) 藕打花刀擦干，挂薄粉入油锅炸至金黄，复炸更酥；\n2) 糖醋番茄汁煮至透亮；\n3) 摆形后淋汁，脆皮裹酸甜。
松鼠茭白	苏菜	1) 茭白打花刀擦干，挂薄粉入油锅炸至金黄，复炸更酥；\n2) 糖醋番茄汁煮至透亮；\n3) 摆形后淋汁，脆皮裹酸甜。
松鼠豆腐	苏菜	1) 豆腐打花刀擦干，挂薄粉入油锅炸至金黄，复炸更酥；\n2) 糖醋番茄汁煮至透亮；\n3) 摆形后淋汁，脆皮裹酸甜。
松鼠草头	苏菜	1) 草头打花刀擦干，挂薄粉入油锅炸至金黄，复炸更酥；\n2) 糖醋番茄汁煮至透亮；\n3) 摆形后淋汁，脆皮裹酸甜。
松鼠莼菜	苏菜	1) 莼菜打花刀擦干，挂薄粉入油锅炸至金黄，复炸更酥；\n2) 糖醋番茄汁煮至透亮；\n3) 摆形后淋汁，脆皮裹酸甜。
松鼠蹄膀	苏菜	1) 蹄膀打花刀擦干，挂薄粉入油锅炸至金黄，复炸更酥；\n2) 糖醋番茄汁煮至透亮；\n3) 摆形后淋汁，脆皮裹酸甜。
红烧桂鱼	苏菜	1) 桂鱼焯水或腌制备用；炒糖色至琥珀，下主料上色。\n2) 加生抽/老抽/黄酒/姜葱与热水，小火焖至软烂。\n3) 大火收汁至浓亮，口味微甜咸香。
红烧小排	苏菜	1) 小排焯水或腌制备用；炒糖色至琥珀，下主料上色。\n2) 加生抽/老抽/黄酒/姜葱与热水，小火焖至软烂。\n3) 大火收汁至浓亮，口味微甜咸香。
红烧河鳗	苏菜	1) 河鳗焯水或腌制备用；炒糖色至琥珀，下主料上色。\n2) 加生抽/老抽/黄酒/姜葱与热水，小火焖至软烂。\n3) 大火收汁至浓亮，口味微甜咸香。
红烧甲鱼	苏菜	1) 甲鱼焯水或腌制备用；炒糖色至琥珀，下主料上色。\n2) 加生抽/老抽/黄酒/姜葱与热水，小火焖至软烂。\n3) 大火收汁至浓亮，口味微甜咸香。
红烧鸭	苏菜	1) 鸭焯水或腌制备用；炒糖色至琥珀，下主料上色。\n2) 加生抽/老抽/黄酒/姜葱与热水，小火焖至软烂。\n3) 大火收汁至浓亮，口味微甜咸香。
红烧鸡	苏菜	1) 鸡焯水或腌制备用；炒糖色至琥珀，下主料上色。\n2) 加生抽/老抽/黄酒/姜葱与热水，小火焖至软烂。\n3) 大火收汁至浓亮，口味微甜咸香。
红烧虾仁	苏菜	1) 虾仁焯水或腌制备用；炒糖色至琥珀，下主料上色。\n2) 加生抽/老抽/黄酒/姜葱与热水，小火焖至软烂。\n3) 大火收汁至浓亮，口味微甜咸香。
红烧大闸蟹	苏菜	1) 大闸蟹焯水或腌制备用；炒糖色至琥珀，下主料上色。\n2) 加生抽/老抽/黄酒/姜葱与热水，小火焖至软烂。\n3) 大火收汁至浓亮，口味微甜咸香。
红烧银鱼	苏菜	1) 银鱼焯水或腌制备用；炒糖色至琥珀，下主料上色。\n2) 加生抽/老抽/黄酒/姜葱与热水，小火焖至软烂。\n3) 大火收汁至浓亮，口味微甜咸香。
红烧河虾	苏菜	1) 河虾焯水或腌制备用；炒糖色至琥珀，下主料上色。\n2) 加生抽/老抽/黄酒/姜葱与热水，小火焖至软烂。\n3) 大火收汁至浓亮，口味微甜咸香。
红烧鳝丝	苏菜	1) 鳝丝焯水或腌制备用；炒糖色至琥珀，下主料上色。\n2) 加生抽/老抽/黄酒/姜葱与热水，小火焖至软烂。\n3) 大火收汁至浓亮，口味微甜咸香。
红烧笋	苏菜	1) 笋焯水或腌制备用；炒糖色至琥珀，下主料上色。\n2) 加生抽/老抽/黄酒/姜葱与热水，小火焖至软烂。\n3) 大火收汁至浓亮，口味微甜咸香。
红烧冬瓜	苏菜	1) 冬瓜焯水或腌制备用；炒糖色至琥珀，下主料上色。\n2) 加生抽/老抽/黄酒/姜葱与热水，小火焖至软烂。\n3) 大火收汁至浓亮，口味微甜咸香。
红烧藕	苏菜	1) 藕焯水或腌制备用；炒糖色至琥珀，下主料上色。\n2) 加生抽/老抽/黄酒/姜葱与热水，小火焖至软烂。\n3) 大火收汁至浓亮，口味微甜咸香。
红烧茭白	苏菜	1) 茭白焯水或腌制备用；炒糖色至琥珀，下主料上色。\n2) 加生抽/老抽/黄酒/姜葱与热水，小火焖至软烂。\n3) 大火收汁至浓亮，口味微甜咸香。
红烧豆腐	苏菜	1) 豆腐焯水或腌制备用；炒糖色至琥珀，下主料上色。\n2) 加生抽/老抽/黄酒/姜葱与热水，小火焖至软烂。\n3) 大火收汁至浓亮，口味微甜咸香。
红烧草头	苏菜	1) 草头焯水或腌制备用；炒糖色至琥珀，下主料上色。\n2) 加生抽/老抽/黄酒/姜葱与热水，小火焖至软烂。\n3) 大火收汁至浓亮，口味微甜咸香。
红烧莼菜	苏菜	1) 莼菜焯水或腌制备用；炒糖色至琥珀，下主料上色。\n2) 加生抽/老抽/黄酒/姜葱与热水，小火焖至软烂。\n3) 大火收汁至浓亮，口味微甜咸香。
红烧蹄膀	苏菜	1) 蹄膀焯水或腌制备用；炒糖色至琥珀，下主料上色。\n2) 加生抽/老抽/黄酒/姜葱与热水，小火焖至软烂。\n3) 大火收汁至浓亮，口味微甜咸香。
清炖桂鱼	苏菜	1) 砂锅放桂鱼与姜葱、少许料酒，倒入清水或高汤。\n2) 小火慢炖至软烂清鲜，调盐即可；强调汤清味醇，不重色。
清炖狮子头	苏菜	1) 砂锅放狮子头与姜葱、少许料酒，倒入清水或高汤。\n2) 小火慢炖至软烂清鲜，调盐即可；强调汤清味醇，不重色。
清炖小排	苏菜	1) 砂锅放小排与姜葱、少许料酒，倒入清水或高汤。\n2) 小火慢炖至软烂清鲜，调盐即可；强调汤清味醇，不重色。
清炖鸭	苏菜	1) 砂锅放鸭与姜葱、少许料酒，倒入清水或高汤。\n2) 小火慢炖至软烂清鲜，调盐即可；强调汤清味醇，不重色。
清炖鸡	苏菜	1) 砂锅放鸡与姜葱、少许料酒，倒入清水或高汤。\n2) 小火慢炖至软烂清鲜，调盐即可；强调汤清味醇，不重色。
清炖虾仁	苏菜	1) 砂锅放虾仁与姜葱、少许料酒，倒入清水或高汤。\n2) 小火慢炖至软烂清鲜，调盐即可；强调汤清味醇，不重色。
清炖大闸蟹	苏菜	1) 砂锅放大闸蟹与姜葱、少许料酒，倒入清水或高汤。\n2) 小火慢炖至软烂清鲜，调盐即可；强调汤清味醇，不重色。
清炖银鱼	苏菜	1) 砂锅放银鱼与姜葱、少许料酒，倒入清水或高汤。\n2) 小火慢炖至软烂清鲜，调盐即可；强调汤清味醇，不重色。
清炖鳝丝	苏菜	1) 砂锅放鳝丝与姜葱、少许料酒，倒入清水或高汤。\n2) 小火慢炖至软烂清鲜，调盐即可；强调汤清味醇，不重色。
清炖笋	苏菜	1) 砂锅放笋与姜葱、少许料酒，倒入清水或高汤。\n2) 小火慢炖至软烂清鲜，调盐即可；强调汤清味醇，不重色。
清炖冬瓜	苏菜	1) 砂锅放冬瓜与姜葱、少许料酒，倒入清水或高汤。\n2) 小火慢炖至软烂清鲜，调盐即可；强调汤清味醇，不重色。
清炖藕	苏菜	1) 砂锅放藕与姜葱、少许料酒，倒入清水或高汤。\n2) 小火慢炖至软烂清鲜，调盐即可；强调汤清味醇，不重色。
清炖茭白	苏菜	1) 砂锅放茭白与姜葱、少许料酒，倒入清水或高汤。\n2) 小火慢炖至软烂清鲜，调盐即可；强调汤清味醇，不重色。
清炖豆腐	苏菜	1) 砂锅放豆腐与姜葱、少许料酒，倒入清水或高汤。\n2) 小火慢炖至软烂清鲜，调盐即可；强调汤清味醇，不重色。
清炖草头	苏菜	1) 砂锅放草头与姜葱、少许料酒，倒入清水或高汤。\n2) 小火慢炖至软烂清鲜，调盐即可；强调汤清味醇，不重色。
清炖莼菜	苏菜	1) 砂锅放莼菜与姜葱、少许料酒，倒入清水或高汤。\n2) 小火慢炖至软烂清鲜，调盐即可；强调汤清味醇，不重色。
清炖蹄膀	苏菜	1) 砂锅放蹄膀与姜葱、少许料酒，倒入清水或高汤。\n2) 小火慢炖至软烂清鲜，调盐即可；强调汤清味醇，不重色。
糖醋桂鱼	苏菜	1) 桂鱼处理后干煎/炸至定型；\n2) 调糖醋汁（糖:醋≈2:1，酱油少许、清水与淀粉），入锅煮至透亮；\n3) 回锅裹匀翻炒，酸甜开胃。
糖醋狮子头	苏菜	1) 狮子头处理后干煎/炸至定型；\n2) 调糖醋汁（糖:醋≈2:1，酱油少许、清水与淀粉），入锅煮至透亮；\n3) 回锅裹匀翻炒，酸甜开胃。
糖醋河鳗	苏菜	1) 河鳗处理后干煎/炸至定型；\n2) 调糖醋汁（糖:醋≈2:1，酱油少许、清水与淀粉），入锅煮至透亮；\n3) 回锅裹匀翻炒，酸甜开胃。
糖醋甲鱼	苏菜	1) 甲鱼处理后干煎/炸至定型；\n2) 调糖醋汁（糖:醋≈2:1，酱油少许、清水与淀粉），入锅煮至透亮；\n3) 回锅裹匀翻炒，酸甜开胃。
糖醋鸭	苏菜	1) 鸭处理后干煎/炸至定型；\n2) 调糖醋汁（糖:醋≈2:1，酱油少许、清水与淀粉），入锅煮至透亮；\n3) 回锅裹匀翻炒，酸甜开胃。
糖醋鸡	苏菜	1) 鸡处理后干煎/炸至定型；\n2) 调糖醋汁（糖:醋≈2:1，酱油少许、清水与淀粉），入锅煮至透亮；\n3) 回锅裹匀翻炒，酸甜开胃。
糖醋虾仁	苏菜	1) 虾仁处理后干煎/炸至定型；\n2) 调糖醋汁（糖:醋≈2:1，酱油少许、清水与淀粉），入锅煮至透亮；\n3) 回锅裹匀翻炒，酸甜开胃。
糖醋大闸蟹	苏菜	1) 大闸蟹处理后干煎/炸至定型；\n2) 调糖醋汁（糖:醋≈2:1，酱油少许、清水与淀粉），入锅煮至透亮；\n3) 回锅裹匀翻炒，酸甜开胃。
糖醋银鱼	苏菜	1) 银鱼处理后干煎/炸至定型；\n2) 调糖醋汁（糖:醋≈2:1，酱油少许、清水与淀粉），入锅煮至透亮；\n3) 回锅裹匀翻炒，酸甜开胃。
糖醋河虾	苏菜	1) 河虾处理后干煎/炸至定型；\n2) 调糖醋汁（糖:醋≈2:1，酱油少许、清水与淀粉），入锅煮至透亮；\n3) 回锅裹匀翻炒，酸甜开胃。
糖醋鳝丝	苏菜	1) 鳝丝处理后干煎/炸至定型；\n2) 调糖醋汁（糖:醋≈2:1，酱油少许、清水与淀粉），入锅煮至透亮；\n3) 回锅裹匀翻炒，酸甜开胃。
糖醋笋	苏菜	1) 笋处理后干煎/炸至定型；\n2) 调糖醋汁（糖:醋≈2:1，酱油少许、清水与淀粉），入锅煮至透亮；\n3) 回锅裹匀翻炒，酸甜开胃。
糖醋冬瓜	苏菜	1) 冬瓜处理后干煎/炸至定型；\n2) 调糖醋汁（糖:醋≈2:1，酱油少许、清水与淀粉），入锅煮至透亮；\n3) 回锅裹匀翻炒，酸甜开胃。
糖醋藕	苏菜	1) 藕处理后干煎/炸至定型；\n2) 调糖醋汁（糖:醋≈2:1，酱油少许、清水与淀粉），入锅煮至透亮；\n3) 回锅裹匀翻炒，酸甜开胃。
糖醋茭白	苏菜	1) 茭白处理后干煎/炸至定型；\n2) 调糖醋汁（糖:醋≈2:1，酱油少许、清水与淀粉），入锅煮至透亮；\n3) 回锅裹匀翻炒，酸甜开胃。
糖醋豆腐	苏菜	1) 豆腐处理后干煎/炸至定型；\n2) 调糖醋汁（糖:醋≈2:1，酱油少许、清水与淀粉），入锅煮至透亮；\n3) 回锅裹匀翻炒，酸甜开胃。
糖醋草头	苏菜	1) 草头处理后干煎/炸至定型；\n2) 调糖醋汁（糖:醋≈2:1，酱油少许、清水与淀粉），入锅煮至透亮；\n3) 回锅裹匀翻炒，酸甜开胃。
糖醋莼菜	苏菜	1) 莼菜处理后干煎/炸至定型；\n2) 调糖醋汁（糖:醋≈2:1，酱油少许、清水与淀粉），入锅煮至透亮；\n3) 回锅裹匀翻炒，酸甜开胃。
糖醋蹄膀	苏菜	1) 蹄膀处理后干煎/炸至定型；\n2) 调糖醋汁（糖:醋≈2:1，酱油少许、清水与淀粉），入锅煮至透亮；\n3) 回锅裹匀翻炒，酸甜开胃。
蟹粉桂鱼	苏菜	1) 蟹黄/蟹粉与葱姜爆香，加黄酒与高汤略熬；\n2) 下桂鱼（或提前处理好的丸子/豆腐/小排等），微火煨入味；\n3) 以盐/糖调味，勾薄芡，淋上猪油或鸡油提香。
蟹粉狮子头	苏菜	1) 蟹黄/蟹粉与葱姜爆香，加黄酒与高汤略熬；\n2) 下狮子头（或提前处理好的丸子/豆腐/小排等），微火煨入味；\n3) 以盐/糖调味，勾薄芡，淋上猪油或鸡油提香。
蟹粉小排	苏菜	1) 蟹黄/蟹粉与葱姜爆香，加黄酒与高汤略熬；\n2) 下小排（或提前处理好的丸子/豆腐/小排等），微火煨入味；\n3) 以盐/糖调味，勾薄芡，淋上猪油或鸡油提香。
蟹粉河鳗	苏菜	1) 蟹黄/蟹粉与葱姜爆香，加黄酒与高汤略熬；\n2) 下河鳗（或提前处理好的丸子/豆腐/小排等），微火煨入味；\n3) 以盐/糖调味，勾薄芡，淋上猪油或鸡油提香。
蟹粉甲鱼	苏菜	1) 蟹黄/蟹粉与葱姜爆香，加黄酒与高汤略熬；\n2) 下甲鱼（或提前处理好的丸子/豆腐/小排等），微火煨入味；\n3) 以盐/糖调味，勾薄芡，淋上猪油或鸡油提香。
蟹粉鸭	苏菜	1) 蟹黄/蟹粉与葱姜爆香，加黄酒与高汤略熬；\n2) 下鸭（或提前处理好的丸子/豆腐/小排等），微火煨入味；\n3) 以盐/糖调味，勾薄芡，淋上猪油或鸡油提香。
西湖醋鱼	浙菜	1) 注重清鲜与本味，茶香/酒香/醋香常见。\n2) 多用清蒸/葱烤/东坡类红烧，口味不厚重。\n3) 汤汁讲究清澈与粘亮度。
东坡肉	浙菜	1) 五花肉整块焯水后擦干，改见方；砂锅垫葱姜。\n2) 砂糖炒成糖色，放肉块上色；加黄酒足量、生抽/老抽少许、葱姜、八角。\n3) 盖小火焖2~3小时至软糯，汤汁粘亮即成。
龙井虾仁	浙菜	1) 河虾仁挑筋洗净，盐/糖/蛋清/湿淀粉/少许油抓匀。\n2) 龙井茶叶用80℃热水泡出茶汤与茶叶。\n3) 温油滑炒虾仁至八成熟盛出；锅留底油，下茶叶略爆，倒入茶汤与虾仁，勾薄芡即出。
油焖春笋	浙菜	1) 春笋与葱姜蒜同炒，加入生抽/老抽/糖，注少量高汤；\n2) 小火焖至油润透亮，咸鲜偏甜。
宋嫂鱼羹	浙菜	1) 注重清鲜与本味，茶香/酒香/醋香常见。\n2) 多用清蒸/葱烤/东坡类红烧，口味不厚重。\n3) 汤汁讲究清澈与粘亮度。
叫化鸡	浙菜	1) 鸡腌好后包入荷叶或泥封，外层再包锡纸；\n2) 入烤箱或窑烤至熟透，拆封即食，肉香叶香融合。
杭州酱鸭	浙菜	1) 注重清鲜与本味，茶香/酒香/醋香常见。\n2) 多用清蒸/葱烤/东坡类红烧，口味不厚重。\n3) 汤汁讲究清澈与粘亮度。
雪菜黄鱼	浙菜	1) 注重清鲜与本味，茶香/酒香/醋香常见。\n2) 多用清蒸/葱烤/东坡类红烧，口味不厚重。\n3) 汤汁讲究清澈与粘亮度。
八宝菜	浙菜	1) 注重清鲜与本味，茶香/酒香/醋香常见。\n2) 多用清蒸/葱烤/东坡类红烧，口味不厚重。\n3) 汤汁讲究清澈与粘亮度。
笋干老鸭煲	浙菜	1) 注重清鲜与本味，茶香/酒香/醋香常见。\n2) 多用清蒸/葱烤/东坡类红烧，口味不厚重。\n3) 汤汁讲究清澈与粘亮度。
西湖莼菜汤	浙菜	1) 注重清鲜与本味，茶香/酒香/醋香常见。\n2) 多用清蒸/葱烤/东坡类红烧，口味不厚重。\n3) 汤汁讲究清澈与粘亮度。
糟溜鱼片	浙菜	1) 注重清鲜与本味，茶香/酒香/醋香常见。\n2) 多用清蒸/葱烤/东坡类红烧，口味不厚重。\n3) 汤汁讲究清澈与粘亮度。
虾爆鳝面	浙菜	1) 注重清鲜与本味，茶香/酒香/醋香常见。\n2) 多用清蒸/葱烤/东坡类红烧，口味不厚重。\n3) 汤汁讲究清澈与粘亮度。
腌笃鲜	浙菜	1) 注重清鲜与本味，茶香/酒香/醋香常见。\n2) 多用清蒸/葱烤/东坡类红烧，口味不厚重。\n3) 汤汁讲究清澈与粘亮度。
响油鳝糊	浙菜	1) 注重清鲜与本味，茶香/酒香/醋香常见。\n2) 多用清蒸/葱烤/东坡类红烧，口味不厚重。\n3) 汤汁讲究清澈与粘亮度。
霉干菜扣肉	浙菜	1) 五花肉整块焯后刮净，皮面抹老抽炸至起泡，切厚片。\n2) 霉干菜洗净泡发炒香；碗内皮向下码肉与霉干菜。\n3) 浇酱汁（生抽/老抽/糖/黄酒），上笼蒸2小时，倒扣成型。
绍兴醉鸡	浙菜	1) 注重清鲜与本味，茶香/酒香/醋香常见。\n2) 多用清蒸/葱烤/东坡类红烧，口味不厚重。\n3) 汤汁讲究清澈与粘亮度。
蜜汁火方	浙菜	1) 注重清鲜与本味，茶香/酒香/醋香常见。\n2) 多用清蒸/葱烤/东坡类红烧，口味不厚重。\n3) 汤汁讲究清澈与粘亮度。
葱烤鲫鱼	浙菜	1) 大量葱段入油煸香，下鲫鱼煎至上色；\n2) 加酱油/黄酒与少量糖，小火焖至软烂，葱香浓郁。
鱼头豆腐汤	浙菜	1) 注重清鲜与本味，茶香/酒香/醋香常见。\n2) 多用清蒸/葱烤/东坡类红烧，口味不厚重。\n3) 汤汁讲究清澈与粘亮度。
西湖醋肉	浙菜	1) 注重清鲜与本味，茶香/酒香/醋香常见。\n2) 多用清蒸/葱烤/东坡类红烧，口味不厚重。\n3) 汤汁讲究清澈与粘亮度。
西湖醋虾仁	浙菜	1) 注重清鲜与本味，茶香/酒香/醋香常见。\n2) 多用清蒸/葱烤/东坡类红烧，口味不厚重。\n3) 汤汁讲究清澈与粘亮度。
西湖醋春笋	浙菜	1) 注重清鲜与本味，茶香/酒香/醋香常见。\n2) 多用清蒸/葱烤/东坡类红烧，口味不厚重。\n3) 汤汁讲究清澈与粘亮度。
西湖醋鳝鱼	浙菜	1) 注重清鲜与本味，茶香/酒香/醋香常见。\n2) 多用清蒸/葱烤/东坡类红烧，口味不厚重。\n3) 汤汁讲究清澈与粘亮度。
西湖醋黄鱼	浙菜	1) 注重清鲜与本味，茶香/酒香/醋香常见。\n2) 多用清蒸/葱烤/东坡类红烧，口味不厚重。\n3) 汤汁讲究清澈与粘亮度。
西湖醋甲鱼	浙菜	1) 注重清鲜与本味，茶香/酒香/醋香常见。\n2) 多用清蒸/葱烤/东坡类红烧，口味不厚重。\n3) 汤汁讲究清澈与粘亮度。
西湖醋鸡	浙菜	1) 注重清鲜与本味，茶香/酒香/醋香常见。\n2) 多用清蒸/葱烤/东坡类红烧，口味不厚重。\n3) 汤汁讲究清澈与粘亮度。
西湖醋鸭	浙菜	1) 注重清鲜与本味，茶香/酒香/醋香常见。\n2) 多用清蒸/葱烤/东坡类红烧，口味不厚重。\n3) 汤汁讲究清澈与粘亮度。
西湖醋豆腐	浙菜	1) 注重清鲜与本味，茶香/酒香/醋香常见。\n2) 多用清蒸/葱烤/东坡类红烧，口味不厚重。\n3) 汤汁讲究清澈与粘亮度。
西湖醋面筋	浙菜	1) 注重清鲜与本味，茶香/酒香/醋香常见。\n2) 多用清蒸/葱烤/东坡类红烧，口味不厚重。\n3) 汤汁讲究清澈与粘亮度。
西湖醋螺蛳	浙菜	1) 注重清鲜与本味，茶香/酒香/醋香常见。\n2) 多用清蒸/葱烤/东坡类红烧，口味不厚重。\n3) 汤汁讲究清澈与粘亮度。
西湖醋莼菜	浙菜	1) 注重清鲜与本味，茶香/酒香/醋香常见。\n2) 多用清蒸/葱烤/东坡类红烧，口味不厚重。\n3) 汤汁讲究清澈与粘亮度。
西湖醋青菜	浙菜	1) 注重清鲜与本味，茶香/酒香/醋香常见。\n2) 多用清蒸/葱烤/东坡类红烧，口味不厚重。\n3) 汤汁讲究清澈与粘亮度。
西湖醋豆皮	浙菜	1) 注重清鲜与本味，茶香/酒香/醋香常见。\n2) 多用清蒸/葱烤/东坡类红烧，口味不厚重。\n3) 汤汁讲究清澈与粘亮度。
东坡鱼	浙菜	1) 鱼先焯后上色，黄酒为主、少量生抽老抽与糖，小火焖至软糯；\n2) 汤色红亮味厚，偏甜咸。
东坡虾仁	浙菜	1) 虾仁先焯后上色，黄酒为主、少量生抽老抽与糖，小火焖至软糯；\n2) 汤色红亮味厚，偏甜咸。
东坡春笋	浙菜	1) 春笋先焯后上色，黄酒为主、少量生抽老抽与糖，小火焖至软糯；\n2) 汤色红亮味厚，偏甜咸。
东坡鳝鱼	浙菜	1) 鳝鱼先焯后上色，黄酒为主、少量生抽老抽与糖，小火焖至软糯；\n2) 汤色红亮味厚，偏甜咸。
东坡黄鱼	浙菜	1) 黄鱼先焯后上色，黄酒为主、少量生抽老抽与糖，小火焖至软糯；\n2) 汤色红亮味厚，偏甜咸。
东坡甲鱼	浙菜	1) 甲鱼先焯后上色，黄酒为主、少量生抽老抽与糖，小火焖至软糯；\n2) 汤色红亮味厚，偏甜咸。
东坡鸡	浙菜	1) 鸡先焯后上色，黄酒为主、少量生抽老抽与糖，小火焖至软糯；\n2) 汤色红亮味厚，偏甜咸。
东坡鸭	浙菜	1) 鸭先焯后上色，黄酒为主、少量生抽老抽与糖，小火焖至软糯；\n2) 汤色红亮味厚，偏甜咸。
东坡豆腐	浙菜	1) 豆腐先焯后上色，黄酒为主、少量生抽老抽与糖，小火焖至软糯；\n2) 汤色红亮味厚，偏甜咸。
东坡面筋	浙菜	1) 面筋先焯后上色，黄酒为主、少量生抽老抽与糖，小火焖至软糯；\n2) 汤色红亮味厚，偏甜咸。
东坡螺蛳	浙菜	1) 螺蛳先焯后上色，黄酒为主、少量生抽老抽与糖，小火焖至软糯；\n2) 汤色红亮味厚，偏甜咸。
东坡莼菜	浙菜	1) 莼菜先焯后上色，黄酒为主、少量生抽老抽与糖，小火焖至软糯；\n2) 汤色红亮味厚，偏甜咸。
东坡青菜	浙菜	1) 青菜先焯后上色，黄酒为主、少量生抽老抽与糖，小火焖至软糯；\n2) 汤色红亮味厚，偏甜咸。
东坡豆皮	浙菜	1) 豆皮先焯后上色，黄酒为主、少量生抽老抽与糖，小火焖至软糯；\n2) 汤色红亮味厚，偏甜咸。
龙井鱼	浙菜	1) 龙井茶以80℃热水泡出茶汤；\n2) 鱼以蛋清与湿淀粉抓匀，温油滑至八成熟；\n3) 入茶汤略勾薄芡，清香怡人。
龙井肉	浙菜	1) 龙井茶以80℃热水泡出茶汤；\n2) 肉以蛋清与湿淀粉抓匀，温油滑至八成熟；\n3) 入茶汤略勾薄芡，清香怡人。
龙井春笋	浙菜	1) 龙井茶以80℃热水泡出茶汤；\n2) 春笋以蛋清与湿淀粉抓匀，温油滑至八成熟；\n3) 入茶汤略勾薄芡，清香怡人。
龙井鳝鱼	浙菜	1) 龙井茶以80℃热水泡出茶汤；\n2) 鳝鱼以蛋清与湿淀粉抓匀，温油滑至八成熟；\n3) 入茶汤略勾薄芡，清香怡人。
龙井黄鱼	浙菜	1) 龙井茶以80℃热水泡出茶汤；\n2) 黄鱼以蛋清与湿淀粉抓匀，温油滑至八成熟；\n3) 入茶汤略勾薄芡，清香怡人。
龙井甲鱼	浙菜	1) 龙井茶以80℃热水泡出茶汤；\n2) 甲鱼以蛋清与湿淀粉抓匀，温油滑至八成熟；\n3) 入茶汤略勾薄芡，清香怡人。
龙井鸡	浙菜	1) 龙井茶以80℃热水泡出茶汤；\n2) 鸡以蛋清与湿淀粉抓匀，温油滑至八成熟；\n3) 入茶汤略勾薄芡，清香怡人。
龙井鸭	浙菜	1) 龙井茶以80℃热水泡出茶汤；\n2) 鸭以蛋清与湿淀粉抓匀，温油滑至八成熟；\n3) 入茶汤略勾薄芡，清香怡人。
龙井豆腐	浙菜	1) 龙井茶以80℃热水泡出茶汤；\n2) 豆腐以蛋清与湿淀粉抓匀，温油滑至八成熟；\n3) 入茶汤略勾薄芡，清香怡人。
龙井面筋	浙菜	1) 龙井茶以80℃热水泡出茶汤；\n2) 面筋以蛋清与湿淀粉抓匀，温油滑至八成熟；\n3) 入茶汤略勾薄芡，清香怡人。
龙井螺蛳	浙菜	1) 龙井茶以80℃热水泡出茶汤；\n2) 螺蛳以蛋清与湿淀粉抓匀，温油滑至八成熟；\n3) 入茶汤略勾薄芡，清香怡人。
龙井莼菜	浙菜	1) 龙井茶以80℃热水泡出茶汤；\n2) 莼菜以蛋清与湿淀粉抓匀，温油滑至八成熟；\n3) 入茶汤略勾薄芡，清香怡人。
龙井青菜	浙菜	1) 龙井茶以80℃热水泡出茶汤；\n2) 青菜以蛋清与湿淀粉抓匀，温油滑至八成熟；\n3) 入茶汤略勾薄芡，清香怡人。
龙井豆皮	浙菜	1) 龙井茶以80℃热水泡出茶汤；\n2) 豆皮以蛋清与湿淀粉抓匀，温油滑至八成熟；\n3) 入茶汤略勾薄芡，清香怡人。
油焖鱼	浙菜	1) 鱼与葱姜蒜同炒，加入生抽/老抽/糖，注少量高汤；\n2) 小火焖至油润透亮，咸鲜偏甜。
油焖肉	浙菜	1) 肉与葱姜蒜同炒，加入生抽/老抽/糖，注少量高汤；\n2) 小火焖至油润透亮，咸鲜偏甜。
油焖虾仁	浙菜	1) 虾仁与葱姜蒜同炒，加入生抽/老抽/糖，注少量高汤；\n2) 小火焖至油润透亮，咸鲜偏甜。
油焖鳝鱼	浙菜	1) 鳝鱼与葱姜蒜同炒，加入生抽/老抽/糖，注少量高汤；\n2) 小火焖至油润透亮，咸鲜偏甜。
油焖黄鱼	浙菜	1) 黄鱼与葱姜蒜同炒，加入生抽/老抽/糖，注少量高汤；\n2) 小火焖至油润透亮，咸鲜偏甜。
油焖甲鱼	浙菜	1) 甲鱼与葱姜蒜同炒，加入生抽/老抽/糖，注少量高汤；\n2) 小火焖至油润透亮，咸鲜偏甜。
油焖鸡	浙菜	1) 鸡与葱姜蒜同炒，加入生抽/老抽/糖，注少量高汤；\n2) 小火焖至油润透亮，咸鲜偏甜。
油焖鸭	浙菜	1) 鸭与葱姜蒜同炒，加入生抽/老抽/糖，注少量高汤；\n2) 小火焖至油润透亮，咸鲜偏甜。
油焖豆腐	浙菜	1) 豆腐与葱姜蒜同炒，加入生抽/老抽/糖，注少量高汤；\n2) 小火焖至油润透亮，咸鲜偏甜。
油焖面筋	浙菜	1) 面筋与葱姜蒜同炒，加入生抽/老抽/糖，注少量高汤；\n2) 小火焖至油润透亮，咸鲜偏甜。
油焖螺蛳	浙菜	1) 螺蛳与葱姜蒜同炒，加入生抽/老抽/糖，注少量高汤；\n2) 小火焖至油润透亮，咸鲜偏甜。
油焖莼菜	浙菜	1) 莼菜与葱姜蒜同炒，加入生抽/老抽/糖，注少量高汤；\n2) 小火焖至油润透亮，咸鲜偏甜。
油焖青菜	浙菜	1) 青菜与葱姜蒜同炒，加入生抽/老抽/糖，注少量高汤；\n2) 小火焖至油润透亮，咸鲜偏甜。
油焖豆皮	浙菜	1) 豆皮与葱姜蒜同炒，加入生抽/老抽/糖，注少量高汤；\n2) 小火焖至油润透亮，咸鲜偏甜。
叫化鱼	浙菜	1) 鱼腌好后包入荷叶或泥封，外层再包锡纸；\n2) 入烤箱或窑烤至熟透，拆封即食，肉香叶香融合。
叫化肉	浙菜	1) 肉腌好后包入荷叶或泥封，外层再包锡纸；\n2) 入烤箱或窑烤至熟透，拆封即食，肉香叶香融合。
叫化虾仁	浙菜	1) 虾仁腌好后包入荷叶或泥封，外层再包锡纸；\n2) 入烤箱或窑烤至熟透，拆封即食，肉香叶香融合。
叫化春笋	浙菜	1) 春笋腌好后包入荷叶或泥封，外层再包锡纸；\n2) 入烤箱或窑烤至熟透，拆封即食，肉香叶香融合。
叫化鳝鱼	浙菜	1) 鳝鱼腌好后包入荷叶或泥封，外层再包锡纸；\n2) 入烤箱或窑烤至熟透，拆封即食，肉香叶香融合。
叫化黄鱼	浙菜	1) 黄鱼腌好后包入荷叶或泥封，外层再包锡纸；\n2) 入烤箱或窑烤至熟透，拆封即食，肉香叶香融合。
叫化甲鱼	浙菜	1) 甲鱼腌好后包入荷叶或泥封，外层再包锡纸；\n2) 入烤箱或窑烤至熟透，拆封即食，肉香叶香融合。
叫化鸭	浙菜	1) 鸭腌好后包入荷叶或泥封，外层再包锡纸；\n2) 入烤箱或窑烤至熟透，拆封即食，肉香叶香融合。
叫化豆腐	浙菜	1) 豆腐腌好后包入荷叶或泥封，外层再包锡纸；\n2) 入烤箱或窑烤至熟透，拆封即食，肉香叶香融合。
叫化面筋	浙菜	1) 面筋腌好后包入荷叶或泥封，外层再包锡纸；\n2) 入烤箱或窑烤至熟透，拆封即食，肉香叶香融合。
叫化螺蛳	浙菜	1) 螺蛳腌好后包入荷叶或泥封，外层再包锡纸；\n2) 入烤箱或窑烤至熟透，拆封即食，肉香叶香融合。
叫化莼菜	浙菜	1) 莼菜腌好后包入荷叶或泥封，外层再包锡纸；\n2) 入烤箱或窑烤至熟透，拆封即食，肉香叶香融合。
叫化青菜	浙菜	1) 青菜腌好后包入荷叶或泥封，外层再包锡纸；\n2) 入烤箱或窑烤至熟透，拆封即食，肉香叶香融合。
叫化豆皮	浙菜	1) 豆皮腌好后包入荷叶或泥封，外层再包锡纸；\n2) 入烤箱或窑烤至熟透，拆封即食，肉香叶香融合。
葱烤鱼	浙菜	1) 大量葱段入油煸香，下鱼煎至上色；\n2) 加酱油/黄酒与少量糖，小火焖至软烂，葱香浓郁。
葱烤肉	浙菜	1) 大量葱段入油煸香，下肉煎至上色；\n2) 加酱油/黄酒与少量糖，小火焖至软烂，葱香浓郁。
葱烤虾仁	浙菜	1) 大量葱段入油煸香，下虾仁煎至上色；\n2) 加酱油/黄酒与少量糖，小火焖至软烂，葱香浓郁。
葱烤春笋	浙菜	1) 大量葱段入油煸香，下春笋煎至上色；\n2) 加酱油/黄酒与少量糖，小火焖至软烂，葱香浓郁。
葱烤鳝鱼	浙菜	1) 大量葱段入油煸香，下鳝鱼煎至上色；\n2) 加酱油/黄酒与少量糖，小火焖至软烂，葱香浓郁。
葱烤黄鱼	浙菜	1) 大量葱段入油煸香，下黄鱼煎至上色；\n2) 加酱油/黄酒与少量糖，小火焖至软烂，葱香浓郁。
葱烤甲鱼	浙菜	1) 大量葱段入油煸香，下甲鱼煎至上色；\n2) 加酱油/黄酒与少量糖，小火焖至软烂，葱香浓郁。
葱烤鸡	浙菜	1) 大量葱段入油煸香，下鸡煎至上色；\n2) 加酱油/黄酒与少量糖，小火焖至软烂，葱香浓郁。
葱烤鸭	浙菜	1) 大量葱段入油煸香，下鸭煎至上色；\n2) 加酱油/黄酒与少量糖，小火焖至软烂，葱香浓郁。
葱烤豆腐	浙菜	1) 大量葱段入油煸香，下豆腐煎至上色；\n2) 加酱油/黄酒与少量糖，小火焖至软烂，葱香浓郁。
佛跳墙	闽菜	1) 海参/鲍鱼/瑶柱/蹄筋/花菇/干贝/排骨等提前泡发与焯水。\n2) 砂锅垫猪肉皮与老母鸡，分层码放主料，加入绍兴黄酒与清汤。\n3) 小火密封焖煮3~4小时至味融，起锅前少许盐调味。
海蛎煎	闽菜	1) 讲究汤与海味互相增鲜，常用沙茶/红糟等调味。\n2) 文火慢炖，口味鲜甜略酸香。
沙茶面	闽菜	1) 面切块/片，加少许盐与油拌匀；\n2) 沙茶酱与蒜末小火炒香，烹黄酒与少量高汤；\n3) 下主料与蔬菜同炒或小火煨，咸香带花生与海鲜风味。
荔枝肉	闽菜	1) 五花肉切厚片，以糖/醋比例偏甜酸腌片刻；挂糊炸至金黄。\n2) 锅内调糖醋汁（糖>醋>酱油），下肉片与菠萝/彩椒翻匀收亮。
烧仙草	闽菜	1) 讲究汤与海味互相增鲜，常用沙茶/红糟等调味。\n2) 文火慢炖，口味鲜甜略酸香。
土笋冻	闽菜	1) 讲究汤与海味互相增鲜，常用沙茶/红糟等调味。\n2) 文火慢炖，口味鲜甜略酸香。
红糟鸡	闽菜	1) 红糟与蒜姜拌匀，下鸡略腌；\n2) 小火炒香后加汤煨熟，以糖与盐调味；\n3) 红糟微酸甜并带酒香。
五香卷	闽菜	1) 讲究汤与海味互相增鲜，常用沙茶/红糟等调味。\n2) 文火慢炖，口味鲜甜略酸香。
淡菜汤	闽菜	1) 讲究汤与海味互相增鲜，常用沙茶/红糟等调味。\n2) 文火慢炖，口味鲜甜略酸香。
扁肉燕	闽菜	1) 讲究汤与海味互相增鲜，常用沙茶/红糟等调味。\n2) 文火慢炖，口味鲜甜略酸香。
太极芋泥	闽菜	1) 准备两色料：白汤（清淡）与红汤（如沙茶/红糟）；\n2) 芋泥分别在两色料中加热至熟；\n3) 分区装盘形成黑白对比，咸鲜带一轻一重两味。
漳州卤面	闽菜	1) 讲究汤与海味互相增鲜，常用沙茶/红糟等调味。\n2) 文火慢炖，口味鲜甜略酸香。
清汤汆海蚌	闽菜	1) 上好清汤与汆海蚌同煮，小火保持清亮不混；\n2) 以盐与胡椒轻调味，突出本味。
福州鱼丸	闽菜	1) 讲究汤与海味互相增鲜，常用沙茶/红糟等调味。\n2) 文火慢炖，口味鲜甜略酸香。
厦门薄饼	闽菜	1) 讲究汤与海味互相增鲜，常用沙茶/红糟等调味。\n2) 文火慢炖，口味鲜甜略酸香。
姜母鸭	闽菜	1) 老姜拍碎爆香，下鸭块煸至出油。\n2) 加红枣/枸杞/米酒与少量酱油，小火焖至软烂，汤成姜香酒气。
醉排骨	闽菜	1) 讲究汤与海味互相增鲜，常用沙茶/红糟等调味。\n2) 文火慢炖，口味鲜甜略酸香。
蚝干焖鸡	闽菜	1) 讲究汤与海味互相增鲜，常用沙茶/红糟等调味。\n2) 文火慢炖，口味鲜甜略酸香。
海蛎汤	闽菜	1) 讲究汤与海味互相增鲜，常用沙茶/红糟等调味。\n2) 文火慢炖，口味鲜甜略酸香。
清炖鸽子	闽菜	1) 砂锅放鸽子与姜葱、少许料酒，倒入清水或高汤。\n2) 小火慢炖至软烂清鲜，调盐即可；强调汤清味醇，不重色。
沙茶海蛎	闽菜	1) 海蛎切块/片，加少许盐与油拌匀；\n2) 沙茶酱与蒜末小火炒香，烹黄酒与少量高汤；\n3) 下主料与蔬菜同炒或小火煨，咸香带花生与海鲜风味。
沙茶花蛤	闽菜	1) 花蛤切块/片，加少许盐与油拌匀；\n2) 沙茶酱与蒜末小火炒香，烹黄酒与少量高汤；\n3) 下主料与蔬菜同炒或小火煨，咸香带花生与海鲜风味。
沙茶淡菜	闽菜	1) 淡菜切块/片，加少许盐与油拌匀；\n2) 沙茶酱与蒜末小火炒香，烹黄酒与少量高汤；\n3) 下主料与蔬菜同炒或小火煨，咸香带花生与海鲜风味。
沙茶鱿鱼	闽菜	1) 鱿鱼切块/片，加少许盐、料酒与淀粉抓匀去腥；\n2) 沙茶酱与蒜末小火炒香，烹黄酒与少量高汤；\n3) 下主料与蔬菜同炒或小火煨，咸香带花生与海鲜风味。
沙茶乌鱼	闽菜	1) 乌鱼切块/片，加少许盐、料酒与淀粉抓匀去腥；\n2) 沙茶酱与蒜末小火炒香，烹黄酒与少量高汤；\n3) 下主料与蔬菜同炒或小火煨，咸香带花生与海鲜风味。
沙茶海蚌	闽菜	1) 海蚌切块/片，加少许盐与油拌匀；\n2) 沙茶酱与蒜末小火炒香，烹黄酒与少量高汤；\n3) 下主料与蔬菜同炒或小火煨，咸香带花生与海鲜风味。
沙茶鸡	闽菜	1) 鸡切块/片，加少许盐、料酒、胡椒与淀粉抓匀；\n2) 沙茶酱与蒜末小火炒香，烹黄酒与少量高汤；\n3) 下主料与蔬菜同炒或小火煨，咸香带花生与海鲜风味。
沙茶鸭	闽菜	1) 鸭切块/片，加少许盐、料酒、胡椒与淀粉抓匀；\n2) 沙茶酱与蒜末小火炒香，烹黄酒与少量高汤；\n3) 下主料与蔬菜同炒或小火煨，咸香带花生与海鲜风味。
沙茶猪脚	闽菜	1) 猪脚切块/片，加少许盐、料酒、生抽与淀粉抓匀；\n2) 沙茶酱与蒜末小火炒香，烹黄酒与少量高汤；\n3) 下主料与蔬菜同炒或小火煨，咸香带花生与海鲜风味。
沙茶米粉	闽菜	1) 米粉切块/片，加少许盐与油拌匀；\n2) 沙茶酱与蒜末小火炒香，烹黄酒与少量高汤；\n3) 下主料与蔬菜同炒或小火煨，咸香带花生与海鲜风味。
沙茶面线	闽菜	1) 面线切块/片，加少许盐与油拌匀；\n2) 沙茶酱与蒜末小火炒香，烹黄酒与少量高汤；\n3) 下主料与蔬菜同炒或小火煨，咸香带花生与海鲜风味。
沙茶海蜇	闽菜	1) 海蜇切块/片，加少许盐与油拌匀；\n2) 沙茶酱与蒜末小火炒香，烹黄酒与少量高汤；\n3) 下主料与蔬菜同炒或小火煨，咸香带花生与海鲜风味。
沙茶豆腐	闽菜	1) 豆腐切块/片，加少许盐与油拌匀；\n2) 沙茶酱与蒜末小火炒香，烹黄酒与少量高汤；\n3) 下主料与蔬菜同炒或小火煨，咸香带花生与海鲜风味。
沙茶木耳	闽菜	1) 木耳切块/片，加少许盐与油拌匀；\n2) 沙茶酱与蒜末小火炒香，烹黄酒与少量高汤；\n3) 下主料与蔬菜同炒或小火煨，咸香带花生与海鲜风味。
沙茶牛肉	闽菜	1) 牛肉切块/片，加少许盐、料酒、生抽与淀粉抓匀；\n2) 沙茶酱与蒜末小火炒香，烹黄酒与少量高汤；\n3) 下主料与蔬菜同炒或小火煨，咸香带花生与海鲜风味。
沙茶虾	闽菜	1) 虾切块/片，加少许盐、料酒与淀粉抓匀去腥；\n2) 沙茶酱与蒜末小火炒香，烹黄酒与少量高汤；\n3) 下主料与蔬菜同炒或小火煨，咸香带花生与海鲜风味。
红糟海蛎	闽菜	1) 红糟与蒜姜拌匀，下海蛎略腌；\n2) 小火炒香后加汤煨熟，以糖与盐调味；\n3) 红糟微酸甜并带酒香。
红糟花蛤	闽菜	1) 红糟与蒜姜拌匀，下花蛤略腌；\n2) 小火炒香后加汤煨熟，以糖与盐调味；\n3) 红糟微酸甜并带酒香。
红糟淡菜	闽菜	1) 红糟与蒜姜拌匀，下淡菜略腌；\n2) 小火炒香后加汤煨熟，以糖与盐调味；\n3) 红糟微酸甜并带酒香。
红糟鱿鱼	闽菜	1) 红糟与蒜姜拌匀，下鱿鱼略腌；\n2) 小火炒香后加汤煨熟，以糖与盐调味；\n3) 红糟微酸甜并带酒香。
红糟乌鱼	闽菜	1) 红糟与蒜姜拌匀，下乌鱼略腌；\n2) 小火炒香后加汤煨熟，以糖与盐调味；\n3) 红糟微酸甜并带酒香。
红糟海蚌	闽菜	1) 红糟与蒜姜拌匀，下海蚌略腌；\n2) 小火炒香后加汤煨熟，以糖与盐调味；\n3) 红糟微酸甜并带酒香。
红糟鸭	闽菜	1) 红糟与蒜姜拌匀，下鸭略腌；\n2) 小火炒香后加汤煨熟，以糖与盐调味；\n3) 红糟微酸甜并带酒香。
红糟猪脚	闽菜	1) 红糟与蒜姜拌匀，下猪脚略腌；\n2) 小火炒香后加汤煨熟，以糖与盐调味；\n3) 红糟微酸甜并带酒香。
红糟米粉	闽菜	1) 红糟与蒜姜拌匀，下米粉略腌；\n2) 小火炒香后加汤煨熟，以糖与盐调味；\n3) 红糟微酸甜并带酒香。
红糟面线	闽菜	1) 红糟与蒜姜拌匀，下面线略腌；\n2) 小火炒香后加汤煨熟，以糖与盐调味；\n3) 红糟微酸甜并带酒香。
红糟海蜇	闽菜	1) 红糟与蒜姜拌匀，下海蜇略腌；\n2) 小火炒香后加汤煨熟，以糖与盐调味；\n3) 红糟微酸甜并带酒香。
红糟豆腐	闽菜	1) 红糟与蒜姜拌匀，下豆腐略腌；\n2) 小火炒香后加汤煨熟，以糖与盐调味；\n3) 红糟微酸甜并带酒香。
红糟木耳	闽菜	1) 红糟与蒜姜拌匀，下木耳略腌；\n2) 小火炒香后加汤煨熟，以糖与盐调味；\n3) 红糟微酸甜并带酒香。
红糟牛肉	闽菜	1) 红糟与蒜姜拌匀，下牛肉略腌；\n2) 小火炒香后加汤煨熟，以糖与盐调味；\n3) 红糟微酸甜并带酒香。
红糟虾	闽菜	1) 红糟与蒜姜拌匀，下虾略腌；\n2) 小火炒香后加汤煨熟，以糖与盐调味；\n3) 红糟微酸甜并带酒香。
芋泥海蛎	闽菜	1) 芋头蒸熟压泥，与猪油/糖/少许椰奶拌至细腻；\n2) 海蛎处理后与芋泥同装，或芋泥做底，主料做浇头；\n3) 口感绵润，偏甜咸。
芋泥花蛤	闽菜	1) 芋头蒸熟压泥，与猪油/糖/少许椰奶拌至细腻；\n2) 花蛤处理后与芋泥同装，或芋泥做底，主料做浇头；\n3) 口感绵润，偏甜咸。
芋泥淡菜	闽菜	1) 芋头蒸熟压泥，与猪油/糖/少许椰奶拌至细腻；\n2) 淡菜处理后与芋泥同装，或芋泥做底，主料做浇头；\n3) 口感绵润，偏甜咸。
芋泥鱿鱼	闽菜	1) 芋头蒸熟压泥，与猪油/糖/少许椰奶拌至细腻；\n2) 鱿鱼处理后与芋泥同装，或芋泥做底，主料做浇头；\n3) 口感绵润，偏甜咸。
芋泥乌鱼	闽菜	1) 芋头蒸熟压泥，与猪油/糖/少许椰奶拌至细腻；\n2) 乌鱼处理后与芋泥同装，或芋泥做底，主料做浇头；\n3) 口感绵润，偏甜咸。
芋泥海蚌	闽菜	1) 芋头蒸熟压泥，与猪油/糖/少许椰奶拌至细腻；\n2) 海蚌处理后与芋泥同装，或芋泥做底，主料做浇头；\n3) 口感绵润，偏甜咸。
芋泥鸡	闽菜	1) 芋头蒸熟压泥，与猪油/糖/少许椰奶拌至细腻；\n2) 鸡处理后与芋泥同装，或芋泥做底，主料做浇头；\n3) 口感绵润，偏甜咸。
芋泥鸭	闽菜	1) 芋头蒸熟压泥，与猪油/糖/少许椰奶拌至细腻；\n2) 鸭处理后与芋泥同装，或芋泥做底，主料做浇头；\n3) 口感绵润，偏甜咸。
芋泥猪脚	闽菜	1) 芋头蒸熟压泥，与猪油/糖/少许椰奶拌至细腻；\n2) 猪脚处理后与芋泥同装，或芋泥做底，主料做浇头；\n3) 口感绵润，偏甜咸。
芋泥米粉	闽菜	1) 芋头蒸熟压泥，与猪油/糖/少许椰奶拌至细腻；\n2) 米粉处理后与芋泥同装，或芋泥做底，主料做浇头；\n3) 口感绵润，偏甜咸。
芋泥面线	闽菜	1) 芋头蒸熟压泥，与猪油/糖/少许椰奶拌至细腻；\n2) 面线处理后与芋泥同装，或芋泥做底，主料做浇头；\n3) 口感绵润，偏甜咸。
芋泥海蜇	闽菜	1) 芋头蒸熟压泥，与猪油/糖/少许椰奶拌至细腻；\n2) 海蜇处理后与芋泥同装，或芋泥做底，主料做浇头；\n3) 口感绵润，偏甜咸。
芋泥豆腐	闽菜	1) 芋头蒸熟压泥，与猪油/糖/少许椰奶拌至细腻；\n2) 豆腐处理后与芋泥同装，或芋泥做底，主料做浇头；\n3) 口感绵润，偏甜咸。
芋泥木耳	闽菜	1) 芋头蒸熟压泥，与猪油/糖/少许椰奶拌至细腻；\n2) 木耳处理后与芋泥同装，或芋泥做底，主料做浇头；\n3) 口感绵润，偏甜咸。
芋泥牛肉	闽菜	1) 芋头蒸熟压泥，与猪油/糖/少许椰奶拌至细腻；\n2) 牛肉处理后与芋泥同装，或芋泥做底，主料做浇头；\n3) 口感绵润，偏甜咸。
芋泥虾	闽菜	1) 芋头蒸熟压泥，与猪油/糖/少许椰奶拌至细腻；\n2) 虾处理后与芋泥同装，或芋泥做底，主料做浇头；\n3) 口感绵润，偏甜咸。
太极海蛎	闽菜	1) 准备两色料：白汤（清淡）与红汤（如沙茶/红糟）；\n2) 海蛎分别在两色料中加热至熟；\n3) 分区装盘形成黑白对比，咸鲜带一轻一重两味。
太极花蛤	闽菜	1) 准备两色料：白汤（清淡）与红汤（如沙茶/红糟）；\n2) 花蛤分别在两色料中加热至熟；\n3) 分区装盘形成黑白对比，咸鲜带一轻一重两味。
太极淡菜	闽菜	1) 准备两色料：白汤（清淡）与红汤（如沙茶/红糟）；\n2) 淡菜分别在两色料中加热至熟；\n3) 分区装盘形成黑白对比，咸鲜带一轻一重两味。
太极鱿鱼	闽菜	1) 准备两色料：白汤（清淡）与红汤（如沙茶/红糟）；\n2) 鱿鱼分别在两色料中加热至熟；\n3) 分区装盘形成黑白对比，咸鲜带一轻一重两味。
太极乌鱼	闽菜	1) 准备两色料：白汤（清淡）与红汤（如沙茶/红糟）；\n2) 乌鱼分别在两色料中加热至熟；\n3) 分区装盘形成黑白对比，咸鲜带一轻一重两味。
太极海蚌	闽菜	1) 准备两色料：白汤（清淡）与红汤（如沙茶/红糟）；\n2) 海蚌分别在两色料中加热至熟；\n3) 分区装盘形成黑白对比，咸鲜带一轻一重两味。
太极鸡	闽菜	1) 准备两色料：白汤（清淡）与红汤（如沙茶/红糟）；\n2) 鸡分别在两色料中加热至熟；\n3) 分区装盘形成黑白对比，咸鲜带一轻一重两味。
太极鸭	闽菜	1) 准备两色料：白汤（清淡）与红汤（如沙茶/红糟）；\n2) 鸭分别在两色料中加热至熟；\n3) 分区装盘形成黑白对比，咸鲜带一轻一重两味。
太极猪脚	闽菜	1) 准备两色料：白汤（清淡）与红汤（如沙茶/红糟）；\n2) 猪脚分别在两色料中加热至熟；\n3) 分区装盘形成黑白对比，咸鲜带一轻一重两味。
太极米粉	闽菜	1) 准备两色料：白汤（清淡）与红汤（如沙茶/红糟）；\n2) 米粉分别在两色料中加热至熟；\n3) 分区装盘形成黑白对比，咸鲜带一轻一重两味。
太极面线	闽菜	1) 准备两色料：白汤（清淡）与红汤（如沙茶/红糟）；\n2) 面线分别在两色料中加热至熟；\n3) 分区装盘形成黑白对比，咸鲜带一轻一重两味。
太极海蜇	闽菜	1) 准备两色料：白汤（清淡）与红汤（如沙茶/红糟）；\n2) 海蜇分别在两色料中加热至熟；\n3) 分区装盘形成黑白对比，咸鲜带一轻一重两味。
太极豆腐	闽菜	1) 准备两色料：白汤（清淡）与红汤（如沙茶/红糟）；\n2) 豆腐分别在两色料中加热至熟；\n3) 分区装盘形成黑白对比，咸鲜带一轻一重两味。
太极木耳	闽菜	1) 准备两色料：白汤（清淡）与红汤（如沙茶/红糟）；\n2) 木耳分别在两色料中加热至熟；\n3) 分区装盘形成黑白对比，咸鲜带一轻一重两味。
太极牛肉	闽菜	1) 准备两色料：白汤（清淡）与红汤（如沙茶/红糟）；\n2) 牛肉分别在两色料中加热至熟；\n3) 分区装盘形成黑白对比，咸鲜带一轻一重两味。
太极虾	闽菜	1) 准备两色料：白汤（清淡）与红汤（如沙茶/红糟）；\n2) 虾分别在两色料中加热至熟；\n3) 分区装盘形成黑白对比，咸鲜带一轻一重两味。
姜母海蛎	闽菜	1) 讲究汤与海味互相增鲜，常用沙茶/红糟等调味。\n2) 文火慢炖，口味鲜甜略酸香。
姜母花蛤	闽菜	1) 讲究汤与海味互相增鲜，常用沙茶/红糟等调味。\n2) 文火慢炖，口味鲜甜略酸香。
姜母淡菜	闽菜	1) 讲究汤与海味互相增鲜，常用沙茶/红糟等调味。\n2) 文火慢炖，口味鲜甜略酸香。
姜母鱿鱼	闽菜	1) 讲究汤与海味互相增鲜，常用沙茶/红糟等调味。\n2) 文火慢炖，口味鲜甜略酸香。
姜母乌鱼	闽菜	1) 讲究汤与海味互相增鲜，常用沙茶/红糟等调味。\n2) 文火慢炖，口味鲜甜略酸香。
姜母海蚌	闽菜	1) 讲究汤与海味互相增鲜，常用沙茶/红糟等调味。\n2) 文火慢炖，口味鲜甜略酸香。
姜母鸡	闽菜	1) 讲究汤与海味互相增鲜，常用沙茶/红糟等调味。\n2) 文火慢炖，口味鲜甜略酸香。
姜母猪脚	闽菜	1) 讲究汤与海味互相增鲜，常用沙茶/红糟等调味。\n2) 文火慢炖，口味鲜甜略酸香。
姜母米粉	闽菜	1) 讲究汤与海味互相增鲜，常用沙茶/红糟等调味。\n2) 文火慢炖，口味鲜甜略酸香。
姜母面线	闽菜	1) 讲究汤与海味互相增鲜，常用沙茶/红糟等调味。\n2) 文火慢炖，口味鲜甜略酸香。
姜母海蜇	闽菜	1) 讲究汤与海味互相增鲜，常用沙茶/红糟等调味。\n2) 文火慢炖，口味鲜甜略酸香。
姜母豆腐	闽菜	1) 讲究汤与海味互相增鲜，常用沙茶/红糟等调味。\n2) 文火慢炖，口味鲜甜略酸香。
姜母木耳	闽菜	1) 讲究汤与海味互相增鲜，常用沙茶/红糟等调味。\n2) 文火慢炖，口味鲜甜略酸香。
姜母牛肉	闽菜	1) 讲究汤与海味互相增鲜，常用沙茶/红糟等调味。\n2) 文火慢炖，口味鲜甜略酸香。
姜母虾	闽菜	1) 讲究汤与海味互相增鲜，常用沙茶/红糟等调味。\n2) 文火慢炖，口味鲜甜略酸香。
醉海蛎	闽菜	1) 讲究汤与海味互相增鲜，常用沙茶/红糟等调味。\n2) 文火慢炖，口味鲜甜略酸香。
醉花蛤	闽菜	1) 讲究汤与海味互相增鲜，常用沙茶/红糟等调味。\n2) 文火慢炖，口味鲜甜略酸香。
剁椒鱼头	湘菜	1) 花鲢鱼头对剖洗净，抹盐与料酒，垫姜蒜。\n2) 铺满自制剁椒与蒸鱼豉油，大火蒸8~10分钟；出锅撒葱花浇热油。
毛氏红烧肉	湘菜	1) 五花肉块焯水后擦干；炒糖色至琥珀，下肉煸匀上色。\n2) 加生抽/老抽/料酒/八角/姜片/开水，小火焖至软糯。\n3) 大火收汁至浓亮，略带甜咸，以米酒提香。
辣椒炒肉	湘菜	1) 主料切片/块腌制；小米辣/蒜姜切碎。\n2) 猛火爆香辣椒与蒜姜，下主料快炒，少量酱油与醋提味。\n3) 收汁微干，保持镬气。
口味虾	湘菜	1) 虾切块/片腌制；小米辣/二荆条/蒜姜切碎。\n2) 下油爆香辣椒与蒜姜，放入主料大火快炒，烹生抽/老抽与少量醋。\n3) 加少量清水或高汤，收汁见油亮，咸辣香重。
小炒黄牛肉	湘菜	1) 黄牛肉切薄片腌制；青红椒大量切圈，蒜姜拍碎。\n2) 猛火热锅宽油，下主料迅速滑散，随即下辣椒圈爆香。\n3) 调生抽/盐/少许糖，略收汁出锅，保持“镬气”。
干锅手撕包菜	湘菜	1) 手撕包菜预处理：肉类先腌后滑油/焯水，蔬菜如洋葱/芹菜/藕片备好。\n2) 锅中底油，下豆瓣/辣椒面/花椒炒香，少许火锅底料增香。\n3) 下手撕包菜翻炒断生，加入配菜大火煸香。\n4) 调入生抽/老抽/糖/少量高汤，收至干香，撒葱段与芝麻，上桌可置小炉保温。
麻辣小龙虾	湘菜	1) 小龙虾切块/段，加少许盐、料酒与淀粉抓匀去腥；干辣椒段、花椒粒、蒜片、姜片、葱段备好。\n2) 锅入少许底油，小火炒香花椒与干辣椒，出香不糊。\n3) 下小龙虾大火翻炒至断生，烹生抽/料酒，少许糖提味。\n4) 继续翻炒至入味，可加少量高汤，收至微干；撒葱段芝麻。
外婆菜炒肉末	湘菜	1) 主料切片/块腌制；小米辣/蒜姜切碎。\n2) 猛火爆香辣椒与蒜姜，下主料快炒，少量酱油与醋提味。\n3) 收汁微干，保持镬气。
芹菜炒腊肉	湘菜	1) 主料切片/块腌制；小米辣/蒜姜切碎。\n2) 猛火爆香辣椒与蒜姜，下主料快炒，少量酱油与醋提味。\n3) 收汁微干，保持镬气。
酸豆角炒肉末	湘菜	1) 主料切片/块腌制；小米辣/蒜姜切碎。\n2) 猛火爆香辣椒与蒜姜，下主料快炒，少量酱油与醋提味。\n3) 收汁微干，保持镬气。
剁椒蒸茄子	湘菜	1) 蒸茄子改刀放盘，抹少许盐/料酒；铺上姜蒜末与足量剁椒。\n2) 大火入笼蒸熟（鱼8~10分钟、肉10~15分钟，视原料而定）。\n3) 出锅撒葱花，浇少许热油激香，沿边淋蒸鱼豉油。
麻辣肥肠	湘菜	1) 肥肠切块/段，加少许盐、料酒、生抽与淀粉抓匀；干辣椒段、花椒粒、蒜片、姜片、葱段备好。\n2) 锅入少许底油，小火炒香花椒与干辣椒，出香不糊。\n3) 下肥肠大火翻炒至断生，烹生抽/料酒，少许糖提味。\n4) 继续翻炒至入味，可加少量高汤，收至微干；撒葱段芝麻。
干锅花菜	湘菜	1) 花菜预处理：肉类先腌后滑油/焯水，蔬菜如洋葱/芹菜/藕片备好。\n2) 锅中底油，下豆瓣/辣椒面/花椒炒香，少许火锅底料增香。\n3) 下花菜翻炒断生，加入配菜大火煸香。\n4) 调入生抽/老抽/糖/少量高汤，收至干香，撒葱段与芝麻，上桌可置小炉保温。
米粉蒸肉	湘菜	1) 主料切片/块腌制；小米辣/蒜姜切碎。\n2) 猛火爆香辣椒与蒜姜，下主料快炒，少量酱油与醋提味。\n3) 收汁微干，保持镬气。
农家一碗香	湘菜	1) 主料切片/块腌制；小米辣/蒜姜切碎。\n2) 猛火爆香辣椒与蒜姜，下主料快炒，少量酱油与醋提味。\n3) 收汁微干，保持镬气。
鱼头豆腐汤	湘菜	1) 主料切片/块腌制；小米辣/蒜姜切碎。\n2) 猛火爆香辣椒与蒜姜，下主料快炒，少量酱油与醋提味。\n3) 收汁微干，保持镬气。
柴火鸡	湘菜	1) 主料切片/块腌制；小米辣/蒜姜切碎。\n2) 猛火爆香辣椒与蒜姜，下主料快炒，少量酱油与醋提味。\n3) 收汁微干，保持镬气。
辣椒炒蛋	湘菜	1) 主料切片/块腌制；小米辣/蒜姜切碎。\n2) 猛火爆香辣椒与蒜姜，下主料快炒，少量酱油与醋提味。\n3) 收汁微干，保持镬气。
坛子肉	湘菜	1) 主料切片/块腌制；小米辣/蒜姜切碎。\n2) 猛火爆香辣椒与蒜姜，下主料快炒，少量酱油与醋提味。\n3) 收汁微干，保持镬气。
剁椒蒸鱼	湘菜	1) 蒸鱼改刀放盘，抹少许盐/料酒；铺上姜蒜末与足量剁椒。\n2) 大火入笼蒸熟（鱼8~10分钟、肉10~15分钟，视原料而定）。\n3) 出锅撒葱花，浇少许热油激香，沿边淋蒸鱼豉油。
剁椒五花肉	湘菜	1) 五花肉改刀放盘，抹少许盐/料酒；铺上姜蒜末与足量剁椒。\n2) 大火入笼蒸熟（鱼8~10分钟、肉10~15分钟，视原料而定）。\n3) 出锅撒葱花，浇少许热油激香，沿边淋蒸鱼豉油。
剁椒猪肉	湘菜	1) 猪肉改刀放盘，抹少许盐/料酒；铺上姜蒜末与足量剁椒。\n2) 大火入笼蒸熟（鱼8~10分钟、肉10~15分钟，视原料而定）。\n3) 出锅撒葱花，浇少许热油激香，沿边淋蒸鱼豉油。
剁椒牛肉	湘菜	1) 牛肉改刀放盘，抹少许盐/料酒；铺上姜蒜末与足量剁椒。\n2) 大火入笼蒸熟（鱼8~10分钟、肉10~15分钟，视原料而定）。\n3) 出锅撒葱花，浇少许热油激香，沿边淋蒸鱼豉油。
剁椒虾	湘菜	1) 虾改刀放盘，抹少许盐/料酒；铺上姜蒜末与足量剁椒。\n2) 大火入笼蒸熟（鱼8~10分钟、肉10~15分钟，视原料而定）。\n3) 出锅撒葱花，浇少许热油激香，沿边淋蒸鱼豉油。
剁椒小龙虾	湘菜	1) 小龙虾改刀放盘，抹少许盐/料酒；铺上姜蒜末与足量剁椒。\n2) 大火入笼蒸熟（鱼8~10分钟、肉10~15分钟，视原料而定）。\n3) 出锅撒葱花，浇少许热油激香，沿边淋蒸鱼豉油。
剁椒鸡	湘菜	1) 鸡改刀放盘，抹少许盐/料酒；铺上姜蒜末与足量剁椒。\n2) 大火入笼蒸熟（鱼8~10分钟、肉10~15分钟，视原料而定）。\n3) 出锅撒葱花，浇少许热油激香，沿边淋蒸鱼豉油。
剁椒鸭	湘菜	1) 鸭改刀放盘，抹少许盐/料酒；铺上姜蒜末与足量剁椒。\n2) 大火入笼蒸熟（鱼8~10分钟、肉10~15分钟，视原料而定）。\n3) 出锅撒葱花，浇少许热油激香，沿边淋蒸鱼豉油。
剁椒藕片	湘菜	1) 藕片改刀放盘，抹少许盐/料酒；铺上姜蒜末与足量剁椒。\n2) 大火入笼蒸熟（鱼8~10分钟、肉10~15分钟，视原料而定）。\n3) 出锅撒葱花，浇少许热油激香，沿边淋蒸鱼豉油。
剁椒土豆片	湘菜	1) 土豆片改刀放盘，抹少许盐/料酒；铺上姜蒜末与足量剁椒。\n2) 大火入笼蒸熟（鱼8~10分钟、肉10~15分钟，视原料而定）。\n3) 出锅撒葱花，浇少许热油激香，沿边淋蒸鱼豉油。
剁椒花菜	湘菜	1) 花菜改刀放盘，抹少许盐/料酒；铺上姜蒜末与足量剁椒。\n2) 大火入笼蒸熟（鱼8~10分钟、肉10~15分钟，视原料而定）。\n3) 出锅撒葱花，浇少许热油激香，沿边淋蒸鱼豉油。
剁椒包菜	湘菜	1) 包菜改刀放盘，抹少许盐/料酒；铺上姜蒜末与足量剁椒。\n2) 大火入笼蒸熟（鱼8~10分钟、肉10~15分钟，视原料而定）。\n3) 出锅撒葱花，浇少许热油激香，沿边淋蒸鱼豉油。
剁椒豆角	湘菜	1) 豆角改刀放盘，抹少许盐/料酒；铺上姜蒜末与足量剁椒。\n2) 大火入笼蒸熟（鱼8~10分钟、肉10~15分钟，视原料而定）。\n3) 出锅撒葱花，浇少许热油激香，沿边淋蒸鱼豉油。
剁椒茄子	湘菜	1) 茄子改刀放盘，抹少许盐/料酒；铺上姜蒜末与足量剁椒。\n2) 大火入笼蒸熟（鱼8~10分钟、肉10~15分钟，视原料而定）。\n3) 出锅撒葱花，浇少许热油激香，沿边淋蒸鱼豉油。
剁椒肥肠	湘菜	1) 肥肠改刀放盘，抹少许盐/料酒；铺上姜蒜末与足量剁椒。\n2) 大火入笼蒸熟（鱼8~10分钟、肉10~15分钟，视原料而定）。\n3) 出锅撒葱花，浇少许热油激香，沿边淋蒸鱼豉油。
剁椒猪肝	湘菜	1) 猪肝改刀放盘，抹少许盐/料酒；铺上姜蒜末与足量剁椒。\n2) 大火入笼蒸熟（鱼8~10分钟、肉10~15分钟，视原料而定）。\n3) 出锅撒葱花，浇少许热油激香，沿边淋蒸鱼豉油。
剁椒猪肚	湘菜	1) 猪肚改刀放盘，抹少许盐/料酒；铺上姜蒜末与足量剁椒。\n2) 大火入笼蒸熟（鱼8~10分钟、肉10~15分钟，视原料而定）。\n3) 出锅撒葱花，浇少许热油激香，沿边淋蒸鱼豉油。
剁椒米粉	湘菜	1) 米粉改刀放盘，抹少许盐/料酒；铺上姜蒜末与足量剁椒。\n2) 大火入笼蒸熟（鱼8~10分钟、肉10~15分钟，视原料而定）。\n3) 出锅撒葱花，浇少许热油激香，沿边淋蒸鱼豉油。
剁椒豆腐	湘菜	1) 豆腐改刀放盘，抹少许盐/料酒；铺上姜蒜末与足量剁椒。\n2) 大火入笼蒸熟（鱼8~10分钟、肉10~15分钟，视原料而定）。\n3) 出锅撒葱花，浇少许热油激香，沿边淋蒸鱼豉油。
剁椒青椒	湘菜	1) 青椒改刀放盘，抹少许盐/料酒；铺上姜蒜末与足量剁椒。\n2) 大火入笼蒸熟（鱼8~10分钟、肉10~15分钟，视原料而定）。\n3) 出锅撒葱花，浇少许热油激香，沿边淋蒸鱼豉油。
毛氏红烧鱼头	湘菜	1) 主料切片/块腌制；小米辣/蒜姜切碎。\n2) 猛火爆香辣椒与蒜姜，下主料快炒，少量酱油与醋提味。\n3) 收汁微干，保持镬气。
毛氏红烧五花肉	湘菜	1) 主料切片/块腌制；小米辣/蒜姜切碎。\n2) 猛火爆香辣椒与蒜姜，下主料快炒，少量酱油与醋提味。\n3) 收汁微干，保持镬气。
毛氏红烧猪肉	湘菜	1) 主料切片/块腌制；小米辣/蒜姜切碎。\n2) 猛火爆香辣椒与蒜姜，下主料快炒，少量酱油与醋提味。\n3) 收汁微干，保持镬气。
毛氏红烧牛肉	湘菜	1) 主料切片/块腌制；小米辣/蒜姜切碎。\n2) 猛火爆香辣椒与蒜姜，下主料快炒，少量酱油与醋提味。\n3) 收汁微干，保持镬气。
毛氏红烧虾	湘菜	1) 主料切片/块腌制；小米辣/蒜姜切碎。\n2) 猛火爆香辣椒与蒜姜，下主料快炒，少量酱油与醋提味。\n3) 收汁微干，保持镬气。
毛氏红烧小龙虾	湘菜	1) 主料切片/块腌制；小米辣/蒜姜切碎。\n2) 猛火爆香辣椒与蒜姜，下主料快炒，少量酱油与醋提味。\n3) 收汁微干，保持镬气。
毛氏红烧鸡	湘菜	1) 主料切片/块腌制；小米辣/蒜姜切碎。\n2) 猛火爆香辣椒与蒜姜，下主料快炒，少量酱油与醋提味。\n3) 收汁微干，保持镬气。
毛氏红烧鸭	湘菜	1) 主料切片/块腌制；小米辣/蒜姜切碎。\n2) 猛火爆香辣椒与蒜姜，下主料快炒，少量酱油与醋提味。\n3) 收汁微干，保持镬气。
毛氏红烧藕片	湘菜	1) 主料切片/块腌制；小米辣/蒜姜切碎。\n2) 猛火爆香辣椒与蒜姜，下主料快炒，少量酱油与醋提味。\n3) 收汁微干，保持镬气。
毛氏红烧土豆片	湘菜	1) 主料切片/块腌制；小米辣/蒜姜切碎。\n2) 猛火爆香辣椒与蒜姜，下主料快炒，少量酱油与醋提味。\n3) 收汁微干，保持镬气。
毛氏红烧花菜	湘菜	1) 主料切片/块腌制；小米辣/蒜姜切碎。\n2) 猛火爆香辣椒与蒜姜，下主料快炒，少量酱油与醋提味。\n3) 收汁微干，保持镬气。
毛氏红烧包菜	湘菜	1) 主料切片/块腌制；小米辣/蒜姜切碎。\n2) 猛火爆香辣椒与蒜姜，下主料快炒，少量酱油与醋提味。\n3) 收汁微干，保持镬气。
毛氏红烧豆角	湘菜	1) 主料切片/块腌制；小米辣/蒜姜切碎。\n2) 猛火爆香辣椒与蒜姜，下主料快炒，少量酱油与醋提味。\n3) 收汁微干，保持镬气。
毛氏红烧茄子	湘菜	1) 主料切片/块腌制；小米辣/蒜姜切碎。\n2) 猛火爆香辣椒与蒜姜，下主料快炒，少量酱油与醋提味。\n3) 收汁微干，保持镬气。
毛氏红烧肥肠	湘菜	1) 主料切片/块腌制；小米辣/蒜姜切碎。\n2) 猛火爆香辣椒与蒜姜，下主料快炒，少量酱油与醋提味。\n3) 收汁微干，保持镬气。
毛氏红烧猪肝	湘菜	1) 主料切片/块腌制；小米辣/蒜姜切碎。\n2) 猛火爆香辣椒与蒜姜，下主料快炒，少量酱油与醋提味。\n3) 收汁微干，保持镬气。
毛氏红烧猪肚	湘菜	1) 主料切片/块腌制；小米辣/蒜姜切碎。\n2) 猛火爆香辣椒与蒜姜，下主料快炒，少量酱油与醋提味。\n3) 收汁微干，保持镬气。
毛氏红烧米粉	湘菜	1) 主料切片/块腌制；小米辣/蒜姜切碎。\n2) 猛火爆香辣椒与蒜姜，下主料快炒，少量酱油与醋提味。\n3) 收汁微干，保持镬气。
毛氏红烧豆腐	湘菜	1) 主料切片/块腌制；小米辣/蒜姜切碎。\n2) 猛火爆香辣椒与蒜姜，下主料快炒，少量酱油与醋提味。\n3) 收汁微干，保持镬气。
毛氏红烧青椒	湘菜	1) 主料切片/块腌制；小米辣/蒜姜切碎。\n2) 猛火爆香辣椒与蒜姜，下主料快炒，少量酱油与醋提味。\n3) 收汁微干，保持镬气。
农家小炒鱼头	湘菜	1) 鱼头切薄片腌制；青红椒大量切圈，蒜姜拍碎。\n2) 猛火热锅宽油，下主料迅速滑散，随即下辣椒圈爆香。\n3) 调生抽/盐/少许糖，略收汁出锅，保持“镬气”。
农家小炒五花肉	湘菜	1) 五花肉切薄片腌制；青红椒大量切圈，蒜姜拍碎。\n2) 猛火热锅宽油，下主料迅速滑散，随即下辣椒圈爆香。\n3) 调生抽/盐/少许糖，略收汁出锅，保持“镬气”。
农家小炒猪肉	湘菜	1) 猪肉切薄片腌制；青红椒大量切圈，蒜姜拍碎。\n2) 猛火热锅宽油，下主料迅速滑散，随即下辣椒圈爆香。\n3) 调生抽/盐/少许糖，略收汁出锅，保持“镬气”。
农家小炒牛肉	湘菜	1) 牛肉切薄片腌制；青红椒大量切圈，蒜姜拍碎。\n2) 猛火热锅宽油，下主料迅速滑散，随即下辣椒圈爆香。\n3) 调生抽/盐/少许糖，略收汁出锅，保持“镬气”。
农家小炒虾	湘菜	1) 虾切薄片腌制；青红椒大量切圈，蒜姜拍碎。\n2) 猛火热锅宽油，下主料迅速滑散，随即下辣椒圈爆香。\n3) 调生抽/盐/少许糖，略收汁出锅，保持“镬气”。
农家小炒小龙虾	湘菜	1) 小龙虾切薄片腌制；青红椒大量切圈，蒜姜拍碎。\n2) 猛火热锅宽油，下主料迅速滑散，随即下辣椒圈爆香。\n3) 调生抽/盐/少许糖，略收汁出锅，保持“镬气”。
农家小炒鸡	湘菜	1) 鸡切薄片腌制；青红椒大量切圈，蒜姜拍碎。\n2) 猛火热锅宽油，下主料迅速滑散，随即下辣椒圈爆香。\n3) 调生抽/盐/少许糖，略收汁出锅，保持“镬气”。
农家小炒鸭	湘菜	1) 鸭切薄片腌制；青红椒大量切圈，蒜姜拍碎。\n2) 猛火热锅宽油，下主料迅速滑散，随即下辣椒圈爆香。\n3) 调生抽/盐/少许糖，略收汁出锅，保持“镬气”。
农家小炒藕片	湘菜	1) 藕片切薄片腌制；青红椒大量切圈，蒜姜拍碎。\n2) 猛火热锅宽油，下主料迅速滑散，随即下辣椒圈爆香。\n3) 调生抽/盐/少许糖，略收汁出锅，保持“镬气”。
农家小炒土豆片	湘菜	1) 土豆片切薄片腌制；青红椒大量切圈，蒜姜拍碎。\n2) 猛火热锅宽油，下主料迅速滑散，随即下辣椒圈爆香。\n3) 调生抽/盐/少许糖，略收汁出锅，保持“镬气”。
农家小炒花菜	湘菜	1) 花菜切薄片腌制；青红椒大量切圈，蒜姜拍碎。\n2) 猛火热锅宽油，下主料迅速滑散，随即下辣椒圈爆香。\n3) 调生抽/盐/少许糖，略收汁出锅，保持“镬气”。
农家小炒包菜	湘菜	1) 包菜切薄片腌制；青红椒大量切圈，蒜姜拍碎。\n2) 猛火热锅宽油，下主料迅速滑散，随即下辣椒圈爆香。\n3) 调生抽/盐/少许糖，略收汁出锅，保持“镬气”。
农家小炒豆角	湘菜	1) 豆角切薄片腌制；青红椒大量切圈，蒜姜拍碎。\n2) 猛火热锅宽油，下主料迅速滑散，随即下辣椒圈爆香。\n3) 调生抽/盐/少许糖，略收汁出锅，保持“镬气”。
农家小炒茄子	湘菜	1) 茄子切薄片腌制；青红椒大量切圈，蒜姜拍碎。\n2) 猛火热锅宽油，下主料迅速滑散，随即下辣椒圈爆香。\n3) 调生抽/盐/少许糖，略收汁出锅，保持“镬气”。
农家小炒肥肠	湘菜	1) 肥肠切薄片腌制；青红椒大量切圈，蒜姜拍碎。\n2) 猛火热锅宽油，下主料迅速滑散，随即下辣椒圈爆香。\n3) 调生抽/盐/少许糖，略收汁出锅，保持“镬气”。
农家小炒猪肝	湘菜	1) 猪肝切薄片腌制；青红椒大量切圈，蒜姜拍碎。\n2) 猛火热锅宽油，下主料迅速滑散，随即下辣椒圈爆香。\n3) 调生抽/盐/少许糖，略收汁出锅，保持“镬气”。
农家小炒猪肚	湘菜	1) 猪肚切薄片腌制；青红椒大量切圈，蒜姜拍碎。\n2) 猛火热锅宽油，下主料迅速滑散，随即下辣椒圈爆香。\n3) 调生抽/盐/少许糖，略收汁出锅，保持“镬气”。
农家小炒米粉	湘菜	1) 米粉切薄片腌制；青红椒大量切圈，蒜姜拍碎。\n2) 猛火热锅宽油，下主料迅速滑散，随即下辣椒圈爆香。\n3) 调生抽/盐/少许糖，略收汁出锅，保持“镬气”。
农家小炒豆腐	湘菜	1) 豆腐切薄片腌制；青红椒大量切圈，蒜姜拍碎。\n2) 猛火热锅宽油，下主料迅速滑散，随即下辣椒圈爆香。\n3) 调生抽/盐/少许糖，略收汁出锅，保持“镬气”。
农家小炒青椒	湘菜	1) 青椒切薄片腌制；青红椒大量切圈，蒜姜拍碎。\n2) 猛火热锅宽油，下主料迅速滑散，随即下辣椒圈爆香。\n3) 调生抽/盐/少许糖，略收汁出锅，保持“镬气”。
口味鱼头	湘菜	1) 鱼头切块/片腌制；小米辣/二荆条/蒜姜切碎。\n2) 下油爆香辣椒与蒜姜，放入主料大火快炒，烹生抽/老抽与少量醋。\n3) 加少量清水或高汤，收汁见油亮，咸辣香重。
口味五花肉	湘菜	1) 五花肉切块/片腌制；小米辣/二荆条/蒜姜切碎。\n2) 下油爆香辣椒与蒜姜，放入主料大火快炒，烹生抽/老抽与少量醋。\n3) 加少量清水或高汤，收汁见油亮，咸辣香重。
口味猪肉	湘菜	1) 猪肉切块/片腌制；小米辣/二荆条/蒜姜切碎。\n2) 下油爆香辣椒与蒜姜，放入主料大火快炒，烹生抽/老抽与少量醋。\n3) 加少量清水或高汤，收汁见油亮，咸辣香重。
口味牛肉	湘菜	1) 牛肉切块/片腌制；小米辣/二荆条/蒜姜切碎。\n2) 下油爆香辣椒与蒜姜，放入主料大火快炒，烹生抽/老抽与少量醋。\n3) 加少量清水或高汤，收汁见油亮，咸辣香重。
口味小龙虾	湘菜	1) 小龙虾切块/片腌制；小米辣/二荆条/蒜姜切碎。\n2) 下油爆香辣椒与蒜姜，放入主料大火快炒，烹生抽/老抽与少量醋。\n3) 加少量清水或高汤，收汁见油亮，咸辣香重。
口味鸡	湘菜	1) 鸡切块/片腌制；小米辣/二荆条/蒜姜切碎。\n2) 下油爆香辣椒与蒜姜，放入主料大火快炒，烹生抽/老抽与少量醋。\n3) 加少量清水或高汤，收汁见油亮，咸辣香重。
口味鸭	湘菜	1) 鸭切块/片腌制；小米辣/二荆条/蒜姜切碎。\n2) 下油爆香辣椒与蒜姜，放入主料大火快炒，烹生抽/老抽与少量醋。\n3) 加少量清水或高汤，收汁见油亮，咸辣香重。
口味藕片	湘菜	1) 藕片切块/片腌制；小米辣/二荆条/蒜姜切碎。\n2) 下油爆香辣椒与蒜姜，放入主料大火快炒，烹生抽/老抽与少量醋。\n3) 加少量清水或高汤，收汁见油亮，咸辣香重。
口味土豆片	湘菜	1) 土豆片切块/片腌制；小米辣/二荆条/蒜姜切碎。\n2) 下油爆香辣椒与蒜姜，放入主料大火快炒，烹生抽/老抽与少量醋。\n3) 加少量清水或高汤，收汁见油亮，咸辣香重。
口味花菜	湘菜	1) 花菜切块/片腌制；小米辣/二荆条/蒜姜切碎。\n2) 下油爆香辣椒与蒜姜，放入主料大火快炒，烹生抽/老抽与少量醋。\n3) 加少量清水或高汤，收汁见油亮，咸辣香重。
口味包菜	湘菜	1) 包菜切块/片腌制；小米辣/二荆条/蒜姜切碎。\n2) 下油爆香辣椒与蒜姜，放入主料大火快炒，烹生抽/老抽与少量醋。\n3) 加少量清水或高汤，收汁见油亮，咸辣香重。
口味豆角	湘菜	1) 豆角切块/片腌制；小米辣/二荆条/蒜姜切碎。\n2) 下油爆香辣椒与蒜姜，放入主料大火快炒，烹生抽/老抽与少量醋。\n3) 加少量清水或高汤，收汁见油亮，咸辣香重。
口味茄子	湘菜	1) 茄子切块/片腌制；小米辣/二荆条/蒜姜切碎。\n2) 下油爆香辣椒与蒜姜，放入主料大火快炒，烹生抽/老抽与少量醋。\n3) 加少量清水或高汤，收汁见油亮，咸辣香重。
口味肥肠	湘菜	1) 肥肠切块/片腌制；小米辣/二荆条/蒜姜切碎。\n2) 下油爆香辣椒与蒜姜，放入主料大火快炒，烹生抽/老抽与少量醋。\n3) 加少量清水或高汤，收汁见油亮，咸辣香重。
口味猪肝	湘菜	1) 猪肝切块/片腌制；小米辣/二荆条/蒜姜切碎。\n2) 下油爆香辣椒与蒜姜，放入主料大火快炒，烹生抽/老抽与少量醋。\n3) 加少量清水或高汤，收汁见油亮，咸辣香重。
口味猪肚	湘菜	1) 猪肚切块/片腌制；小米辣/二荆条/蒜姜切碎。\n2) 下油爆香辣椒与蒜姜，放入主料大火快炒，烹生抽/老抽与少量醋。\n3) 加少量清水或高汤，收汁见油亮，咸辣香重。
口味米粉	湘菜	1) 米粉切块/片腌制；小米辣/二荆条/蒜姜切碎。\n2) 下油爆香辣椒与蒜姜，放入主料大火快炒，烹生抽/老抽与少量醋。\n3) 加少量清水或高汤，收汁见油亮，咸辣香重。
口味豆腐	湘菜	1) 豆腐切块/片腌制；小米辣/二荆条/蒜姜切碎。\n2) 下油爆香辣椒与蒜姜，放入主料大火快炒，烹生抽/老抽与少量醋。\n3) 加少量清水或高汤，收汁见油亮，咸辣香重。
口味青椒	湘菜	1) 青椒切块/片腌制；小米辣/二荆条/蒜姜切碎。\n2) 下油爆香辣椒与蒜姜，放入主料大火快炒，烹生抽/老抽与少量醋。\n3) 加少量清水或高汤，收汁见油亮，咸辣香重。
小炒鱼头	湘菜	1) 鱼头切薄片腌制；青红椒大量切圈，蒜姜拍碎。\n2) 猛火热锅宽油，下主料迅速滑散，随即下辣椒圈爆香。\n3) 调生抽/盐/少许糖，略收汁出锅，保持“镬气”。
小炒五花肉	湘菜	1) 五花肉切薄片腌制；青红椒大量切圈，蒜姜拍碎。\n2) 猛火热锅宽油，下主料迅速滑散，随即下辣椒圈爆香。\n3) 调生抽/盐/少许糖，略收汁出锅，保持“镬气”。
臭鳜鱼	徽菜	1) 慢火焖炖见长，擅用咸鲜与山珍笋干。\n2) 火腿/咸肉提鲜，口味厚实不腻。
毛豆腐	徽菜	1) 慢火焖炖见长，擅用咸鲜与山珍笋干。\n2) 火腿/咸肉提鲜，口味厚实不腻。
徽州一品锅	徽菜	1) 慢火焖炖见长，擅用咸鲜与山珍笋干。\n2) 火腿/咸肉提鲜，口味厚实不腻。
笋干烧肉	徽菜	1) 慢火焖炖见长，擅用咸鲜与山珍笋干。\n2) 火腿/咸肉提鲜，口味厚实不腻。
腌鲜鳜鱼	徽菜	1) 鳜鱼与咸鲜配料（火腿/咸肉/咸菜）同煨；\n2) 高汤/清水小火慢炖，强调“咸鲜本味”，最后轻调盐。
胡适一品锅	徽菜	1) 慢火焖炖见长，擅用咸鲜与山珍笋干。\n2) 火腿/咸肉提鲜，口味厚实不腻。
清炖马蹄鳖	徽菜	1) 砂锅放马蹄鳖与姜葱、少许料酒，倒入清水或高汤。\n2) 小火慢炖至软烂清鲜，调盐即可；强调汤清味醇，不重色。
黄山炖鸽	徽菜	1) 慢火焖炖见长，擅用咸鲜与山珍笋干。\n2) 火腿/咸肉提鲜，口味厚实不腻。
清炖老鸡	徽菜	1) 砂锅放老鸡与姜葱、少许料酒，倒入清水或高汤。\n2) 小火慢炖至软烂清鲜，调盐即可；强调汤清味醇，不重色。
红烧小河鱼	徽菜	1) 小河鱼焯水或腌制备用；炒糖色至琥珀，下主料上色。\n2) 加生抽/老抽/黄酒/姜葱与热水，小火焖至软烂。\n3) 大火收汁至浓亮，口味微甜咸香。
清蒸石鸡	徽菜	1) 石鸡处理干净，抹盐，垫姜丝葱段。\n2) 大火蒸熟（鱼类6~8分钟、贝类3~5分钟、肉类10~15分钟）。\n3) 倒去蒸汁，铺葱丝淋热油，配蒸鱼豉油。
徽州圆子	徽菜	1) 慢火焖炖见长，擅用咸鲜与山珍笋干。\n2) 火腿/咸肉提鲜，口味厚实不腻。
臭鳜鱼梅菜煲	徽菜	1) 慢火焖炖见长，擅用咸鲜与山珍笋干。\n2) 火腿/咸肉提鲜，口味厚实不腻。
刀板香	徽菜	1) 慢火焖炖见长，擅用咸鲜与山珍笋干。\n2) 火腿/咸肉提鲜，口味厚实不腻。
徽式酥鲫鱼	徽菜	1) 慢火焖炖见长，擅用咸鲜与山珍笋干。\n2) 火腿/咸肉提鲜，口味厚实不腻。
火腿炖冬笋	徽菜	1) 金华火腿与冬笋同入砂锅，加清汤；\n2) 小火慢炖至食材彼此增鲜，汤体清润，盐量从轻。
腌鲜竹笋	徽菜	1) 竹笋与咸鲜配料（火腿/咸肉/咸菜）同煨；\n2) 高汤/清水小火慢炖，强调“咸鲜本味”，最后轻调盐。
山粉圆子	徽菜	1) 慢火焖炖见长，擅用咸鲜与山珍笋干。\n2) 火腿/咸肉提鲜，口味厚实不腻。
清炖鹅	徽菜	1) 砂锅放鹅与姜葱、少许料酒，倒入清水或高汤。\n2) 小火慢炖至软烂清鲜，调盐即可；强调汤清味醇，不重色。
渍菜烧豆腐	徽菜	1) 慢火焖炖见长，擅用咸鲜与山珍笋干。\n2) 火腿/咸肉提鲜，口味厚实不腻。
臭鳜鱼鳜鱼	徽菜	1) 慢火焖炖见长，擅用咸鲜与山珍笋干。\n2) 火腿/咸肉提鲜，口味厚实不腻。
臭鳜鱼竹笋	徽菜	1) 慢火焖炖见长，擅用咸鲜与山珍笋干。\n2) 火腿/咸肉提鲜，口味厚实不腻。
臭鳜鱼甲鱼	徽菜	1) 慢火焖炖见长，擅用咸鲜与山珍笋干。\n2) 火腿/咸肉提鲜，口味厚实不腻。
臭鳜鱼土鸡	徽菜	1) 慢火焖炖见长，擅用咸鲜与山珍笋干。\n2) 火腿/咸肉提鲜，口味厚实不腻。
臭鳜鱼老鸭	徽菜	1) 慢火焖炖见长，擅用咸鲜与山珍笋干。\n2) 火腿/咸肉提鲜，口味厚实不腻。
臭鳜鱼石鸡	徽菜	1) 慢火焖炖见长，擅用咸鲜与山珍笋干。\n2) 火腿/咸肉提鲜，口味厚实不腻。
臭鳜鱼圆子	徽菜	1) 慢火焖炖见长，擅用咸鲜与山珍笋干。\n2) 火腿/咸肉提鲜，口味厚实不腻。
臭鳜鱼豆腐	徽菜	1) 慢火焖炖见长，擅用咸鲜与山珍笋干。\n2) 火腿/咸肉提鲜，口味厚实不腻。
臭鳜鱼豆皮	徽菜	1) 慢火焖炖见长，擅用咸鲜与山珍笋干。\n2) 火腿/咸肉提鲜，口味厚实不腻。
臭鳜鱼笋干	徽菜	1) 慢火焖炖见长，擅用咸鲜与山珍笋干。\n2) 火腿/咸肉提鲜，口味厚实不腻。
臭鳜鱼黑猪肉	徽菜	1) 慢火焖炖见长，擅用咸鲜与山珍笋干。\n2) 火腿/咸肉提鲜，口味厚实不腻。
臭鳜鱼河鱼	徽菜	1) 慢火焖炖见长，擅用咸鲜与山珍笋干。\n2) 火腿/咸肉提鲜，口味厚实不腻。
臭鳜鱼板栗	徽菜	1) 慢火焖炖见长，擅用咸鲜与山珍笋干。\n2) 火腿/咸肉提鲜，口味厚实不腻。
臭鳜鱼香菇	徽菜	1) 慢火焖炖见长，擅用咸鲜与山珍笋干。\n2) 火腿/咸肉提鲜，口味厚实不腻。
毛豆腐鳜鱼	徽菜	1) 慢火焖炖见长，擅用咸鲜与山珍笋干。\n2) 火腿/咸肉提鲜，口味厚实不腻。
毛豆腐竹笋	徽菜	1) 慢火焖炖见长，擅用咸鲜与山珍笋干。\n2) 火腿/咸肉提鲜，口味厚实不腻。
毛豆腐甲鱼	徽菜	1) 慢火焖炖见长，擅用咸鲜与山珍笋干。\n2) 火腿/咸肉提鲜，口味厚实不腻。
毛豆腐土鸡	徽菜	1) 慢火焖炖见长，擅用咸鲜与山珍笋干。\n2) 火腿/咸肉提鲜，口味厚实不腻。
毛豆腐老鸭	徽菜	1) 慢火焖炖见长，擅用咸鲜与山珍笋干。\n2) 火腿/咸肉提鲜，口味厚实不腻。
毛豆腐石鸡	徽菜	1) 慢火焖炖见长，擅用咸鲜与山珍笋干。\n2) 火腿/咸肉提鲜，口味厚实不腻。
毛豆腐圆子	徽菜	1) 慢火焖炖见长，擅用咸鲜与山珍笋干。\n2) 火腿/咸肉提鲜，口味厚实不腻。
毛豆腐豆腐	徽菜	1) 慢火焖炖见长，擅用咸鲜与山珍笋干。\n2) 火腿/咸肉提鲜，口味厚实不腻。
毛豆腐豆皮	徽菜	1) 慢火焖炖见长，擅用咸鲜与山珍笋干。\n2) 火腿/咸肉提鲜，口味厚实不腻。
毛豆腐笋干	徽菜	1) 慢火焖炖见长，擅用咸鲜与山珍笋干。\n2) 火腿/咸肉提鲜，口味厚实不腻。
毛豆腐黑猪肉	徽菜	1) 慢火焖炖见长，擅用咸鲜与山珍笋干。\n2) 火腿/咸肉提鲜，口味厚实不腻。
毛豆腐河鱼	徽菜	1) 慢火焖炖见长，擅用咸鲜与山珍笋干。\n2) 火腿/咸肉提鲜，口味厚实不腻。
毛豆腐板栗	徽菜	1) 慢火焖炖见长，擅用咸鲜与山珍笋干。\n2) 火腿/咸肉提鲜，口味厚实不腻。
毛豆腐香菇	徽菜	1) 慢火焖炖见长，擅用咸鲜与山珍笋干。\n2) 火腿/咸肉提鲜，口味厚实不腻。
一品锅鳜鱼	徽菜	1) 慢火焖炖见长，擅用咸鲜与山珍笋干。\n2) 火腿/咸肉提鲜，口味厚实不腻。
一品锅竹笋	徽菜	1) 慢火焖炖见长，擅用咸鲜与山珍笋干。\n2) 火腿/咸肉提鲜，口味厚实不腻。
一品锅甲鱼	徽菜	1) 慢火焖炖见长，擅用咸鲜与山珍笋干。\n2) 火腿/咸肉提鲜，口味厚实不腻。
一品锅土鸡	徽菜	1) 慢火焖炖见长，擅用咸鲜与山珍笋干。\n2) 火腿/咸肉提鲜，口味厚实不腻。
一品锅老鸭	徽菜	1) 慢火焖炖见长，擅用咸鲜与山珍笋干。\n2) 火腿/咸肉提鲜，口味厚实不腻。
一品锅石鸡	徽菜	1) 慢火焖炖见长，擅用咸鲜与山珍笋干。\n2) 火腿/咸肉提鲜，口味厚实不腻。
一品锅圆子	徽菜	1) 慢火焖炖见长，擅用咸鲜与山珍笋干。\n2) 火腿/咸肉提鲜，口味厚实不腻。
一品锅豆腐	徽菜	1) 慢火焖炖见长，擅用咸鲜与山珍笋干。\n2) 火腿/咸肉提鲜，口味厚实不腻。
一品锅豆皮	徽菜	1) 慢火焖炖见长，擅用咸鲜与山珍笋干。\n2) 火腿/咸肉提鲜，口味厚实不腻。
一品锅笋干	徽菜	1) 慢火焖炖见长，擅用咸鲜与山珍笋干。\n2) 火腿/咸肉提鲜，口味厚实不腻。
一品锅黑猪肉	徽菜	1) 慢火焖炖见长，擅用咸鲜与山珍笋干。\n2) 火腿/咸肉提鲜，口味厚实不腻。
一品锅河鱼	徽菜	1) 慢火焖炖见长，擅用咸鲜与山珍笋干。\n2) 火腿/咸肉提鲜，口味厚实不腻。
一品锅板栗	徽菜	1) 慢火焖炖见长，擅用咸鲜与山珍笋干。\n2) 火腿/咸肉提鲜，口味厚实不腻。
一品锅香菇	徽菜	1) 慢火焖炖见长，擅用咸鲜与山珍笋干。\n2) 火腿/咸肉提鲜，口味厚实不腻。
腌鲜甲鱼	徽菜	1) 甲鱼与咸鲜配料（火腿/咸肉/咸菜）同煨；\n2) 高汤/清水小火慢炖，强调“咸鲜本味”，最后轻调盐。
腌鲜土鸡	徽菜	1) 土鸡与咸鲜配料（火腿/咸肉/咸菜）同煨；\n2) 高汤/清水小火慢炖，强调“咸鲜本味”，最后轻调盐。
腌鲜老鸭	徽菜	1) 老鸭与咸鲜配料（火腿/咸肉/咸菜）同煨；\n2) 高汤/清水小火慢炖，强调“咸鲜本味”，最后轻调盐。
腌鲜石鸡	徽菜	1) 石鸡与咸鲜配料（火腿/咸肉/咸菜）同煨；\n2) 高汤/清水小火慢炖，强调“咸鲜本味”，最后轻调盐。
腌鲜圆子	徽菜	1) 圆子与咸鲜配料（火腿/咸肉/咸菜）同煨；\n2) 高汤/清水小火慢炖，强调“咸鲜本味”，最后轻调盐。
腌鲜豆腐	徽菜	1) 豆腐与咸鲜配料（火腿/咸肉/咸菜）同煨；\n2) 高汤/清水小火慢炖，强调“咸鲜本味”，最后轻调盐。
腌鲜豆皮	徽菜	1) 豆皮与咸鲜配料（火腿/咸肉/咸菜）同煨；\n2) 高汤/清水小火慢炖，强调“咸鲜本味”，最后轻调盐。
腌鲜笋干	徽菜	1) 笋干与咸鲜配料（火腿/咸肉/咸菜）同煨；\n2) 高汤/清水小火慢炖，强调“咸鲜本味”，最后轻调盐。
腌鲜黑猪肉	徽菜	1) 黑猪肉与咸鲜配料（火腿/咸肉/咸菜）同煨；\n2) 高汤/清水小火慢炖，强调“咸鲜本味”，最后轻调盐。
腌鲜河鱼	徽菜	1) 河鱼与咸鲜配料（火腿/咸肉/咸菜）同煨；\n2) 高汤/清水小火慢炖，强调“咸鲜本味”，最后轻调盐。
腌鲜板栗	徽菜	1) 板栗与咸鲜配料（火腿/咸肉/咸菜）同煨；\n2) 高汤/清水小火慢炖，强调“咸鲜本味”，最后轻调盐。
腌鲜香菇	徽菜	1) 香菇与咸鲜配料（火腿/咸肉/咸菜）同煨；\n2) 高汤/清水小火慢炖，强调“咸鲜本味”，最后轻调盐。
火腿炖鳜鱼	徽菜	1) 金华火腿与鳜鱼同入砂锅，加清汤；\n2) 小火慢炖至食材彼此增鲜，汤体清润，盐量从轻。
火腿炖竹笋	徽菜	1) 金华火腿与竹笋同入砂锅，加清汤；\n2) 小火慢炖至食材彼此增鲜，汤体清润，盐量从轻。
火腿炖甲鱼	徽菜	1) 金华火腿与甲鱼同入砂锅，加清汤；\n2) 小火慢炖至食材彼此增鲜，汤体清润，盐量从轻。
火腿炖土鸡	徽菜	1) 金华火腿与土鸡同入砂锅，加清汤；\n2) 小火慢炖至食材彼此增鲜，汤体清润，盐量从轻。
火腿炖老鸭	徽菜	1) 金华火腿与老鸭同入砂锅，加清汤；\n2) 小火慢炖至食材彼此增鲜，汤体清润，盐量从轻。
火腿炖石鸡	徽菜	1) 金华火腿与石鸡同入砂锅，加清汤；\n2) 小火慢炖至食材彼此增鲜，汤体清润，盐量从轻。
火腿炖圆子	徽菜	1) 金华火腿与圆子同入砂锅，加清汤；\n2) 小火慢炖至食材彼此增鲜，汤体清润，盐量从轻。
火腿炖豆腐	徽菜	1) 金华火腿与豆腐同入砂锅，加清汤；\n2) 小火慢炖至食材彼此增鲜，汤体清润，盐量从轻。
火腿炖豆皮	徽菜	1) 金华火腿与豆皮同入砂锅，加清汤；\n2) 小火慢炖至食材彼此增鲜，汤体清润，盐量从轻。
火腿炖笋干	徽菜	1) 金华火腿与笋干同入砂锅，加清汤；\n2) 小火慢炖至食材彼此增鲜，汤体清润，盐量从轻。
火腿炖黑猪肉	徽菜	1) 金华火腿与黑猪肉同入砂锅，加清汤；\n2) 小火慢炖至食材彼此增鲜，汤体清润，盐量从轻。
火腿炖河鱼	徽菜	1) 金华火腿与河鱼同入砂锅，加清汤；\n2) 小火慢炖至食材彼此增鲜，汤体清润，盐量从轻。
火腿炖板栗	徽菜	1) 金华火腿与板栗同入砂锅，加清汤；\n2) 小火慢炖至食材彼此增鲜，汤体清润，盐量从轻。
火腿炖香菇	徽菜	1) 金华火腿与香菇同入砂锅，加清汤；\n2) 小火慢炖至食材彼此增鲜，汤体清润，盐量从轻。
清炖鳜鱼	徽菜	1) 砂锅放鳜鱼与姜葱、少许料酒，倒入清水或高汤。\n2) 小火慢炖至软烂清鲜，调盐即可；强调汤清味醇，不重色。
清炖竹笋	徽菜	1) 砂锅放竹笋与姜葱、少许料酒，倒入清水或高汤。\n2) 小火慢炖至软烂清鲜，调盐即可；强调汤清味醇，不重色。
清炖甲鱼	徽菜	1) 砂锅放甲鱼与姜葱、少许料酒，倒入清水或高汤。\n2) 小火慢炖至软烂清鲜，调盐即可；强调汤清味醇，不重色。
清炖土鸡	徽菜	1) 砂锅放土鸡与姜葱、少许料酒，倒入清水或高汤。\n2) 小火慢炖至软烂清鲜，调盐即可；强调汤清味醇，不重色。
清炖老鸭	徽菜	1) 砂锅放老鸭与姜葱、少许料酒，倒入清水或高汤。\n2) 小火慢炖至软烂清鲜，调盐即可；强调汤清味醇，不重色。
清炖石鸡	徽菜	1) 砂锅放石鸡与姜葱、少许料酒，倒入清水或高汤。\n2) 小火慢炖至软烂清鲜，调盐即可；强调汤清味醇，不重色。
清炖圆子	徽菜	1) 砂锅放圆子与姜葱、少许料酒，倒入清水或高汤。\n2) 小火慢炖至软烂清鲜，调盐即可；强调汤清味醇，不重色。
清炖豆腐	徽菜	1) 砂锅放豆腐与姜葱、少许料酒，倒入清水或高汤。\n2) 小火慢炖至软烂清鲜，调盐即可；强调汤清味醇，不重色。
清炖豆皮	徽菜	1) 砂锅放豆皮与姜葱、少许料酒，倒入清水或高汤。\n2) 小火慢炖至软烂清鲜，调盐即可；强调汤清味醇，不重色。
清炖笋干	徽菜	1) 砂锅放笋干与姜葱、少许料酒，倒入清水或高汤。\n2) 小火慢炖至软烂清鲜，调盐即可；强调汤清味醇，不重色。
清炖黑猪肉	徽菜	1) 砂锅放黑猪肉与姜葱、少许料酒，倒入清水或高汤。\n2) 小火慢炖至软烂清鲜，调盐即可；强调汤清味醇，不重色。
清炖河鱼	徽菜	1) 砂锅放河鱼与姜葱、少许料酒，倒入清水或高汤。\n2) 小火慢炖至软烂清鲜，调盐即可；强调汤清味醇，不重色。
九转大肠	鲁菜	1) 大肠多次清洗焯水去腥，切段。\n2) 炒糖色至枣红，下大肠煸匀，加葱姜蒜/八角/桂皮/黄酒/酱油/适量清水。\n3) 小火焖至软烂，勾薄芡，糖醋咸香“九转”层次。
糖醋鲤鱼	鲁菜	1) 鲤鱼处理后干煎/炸至定型；\n2) 调糖醋汁（糖:醋≈2:1，酱油少许、清水与淀粉），入锅煮至透亮；\n3) 回锅裹匀翻炒，酸甜开胃。
葱烧海参	鲁菜	1) 大量大葱段小火炸至微焦出香；\n2) 入海参与生抽/老抽/糖/黄酒/高汤，小火焖至葱香入骨；\n3) 出锅前略收汁。
四喜丸子	鲁菜	1) 善爆善烹，葱烧/清汤/糖醋俱全。\n2) 火候到位，注重汤汁清亮与味厚。
德州扒鸡	鲁菜	1) 善爆善烹，葱烧/清汤/糖醋俱全。\n2) 火候到位，注重汤汁清亮与味厚。
爆三样	鲁菜	1) 善爆善烹，葱烧/清汤/糖醋俱全。\n2) 火候到位，注重汤汁清亮与味厚。
清汤丸子	鲁菜	1) 上好清汤与丸子同煮，小火保持清亮不混；\n2) 以盐与胡椒轻调味，突出本味。
扒海参	鲁菜	1) 海参先煎至定型，再加清汤与少许盐、胡椒；\n2) 小火煨至软嫩，原汤勾薄芡，口味清雅。
一品豆腐	鲁菜	1) 善爆善烹，葱烧/清汤/糖醋俱全。\n2) 火候到位，注重汤汁清亮与味厚。
胶东焖鱼	鲁菜	1) 善爆善烹，葱烧/清汤/糖醋俱全。\n2) 火候到位，注重汤汁清亮与味厚。
油爆双脆	鲁菜	1) 善爆善烹，葱烧/清汤/糖醋俱全。\n2) 火候到位，注重汤汁清亮与味厚。
锅塌豆腐	鲁菜	1) 善爆善烹，葱烧/清汤/糖醋俱全。\n2) 火候到位，注重汤汁清亮与味厚。
清汤燕菜	鲁菜	1) 上好清汤与燕菜同煮，小火保持清亮不混；\n2) 以盐与胡椒轻调味，突出本味。
葱爆羊肉	鲁菜	1) 善爆善烹，葱烧/清汤/糖醋俱全。\n2) 火候到位，注重汤汁清亮与味厚。
黄焖鸡	鲁菜	1) 善爆善烹，葱烧/清汤/糖醋俱全。\n2) 火候到位，注重汤汁清亮与味厚。
锅塌鸡片	鲁菜	1) 善爆善烹，葱烧/清汤/糖醋俱全。\n2) 火候到位，注重汤汁清亮与味厚。
糖醋里脊	鲁菜	1) 里脊处理后干煎/炸至定型；\n2) 调糖醋汁（糖:醋≈2:1，酱油少许、清水与淀粉），入锅煮至透亮；\n3) 回锅裹匀翻炒，酸甜开胃。
京酱肉丝	鲁菜	1) 善爆善烹，葱烧/清汤/糖醋俱全。\n2) 火候到位，注重汤汁清亮与味厚。
锅包肉	鲁菜	1) 善爆善烹，葱烧/清汤/糖醋俱全。\n2) 火候到位，注重汤汁清亮与味厚。
葱烧鲫鱼	鲁菜	1) 大量大葱段小火炸至微焦出香；\n2) 入鲫鱼与生抽/老抽/糖/黄酒/高汤，小火焖至葱香入骨；\n3) 出锅前略收汁。
九转鲤鱼	鲁菜	1) 鲤鱼反复清洗焯水去腥；\n2) 炒糖色，下主料与葱姜蒜、黄酒、八角桂皮，加入酱油与清水小火焖；\n3) 以糖和醋反复调味，收汁浓亮，层次甘香酸甜。
九转海参	鲁菜	1) 海参反复清洗焯水去腥；\n2) 炒糖色，下主料与葱姜蒜、黄酒、八角桂皮，加入酱油与清水小火焖；\n3) 以糖和醋反复调味，收汁浓亮，层次甘香酸甜。
九转肘子	鲁菜	1) 肘子反复清洗焯水去腥；\n2) 炒糖色，下主料与葱姜蒜、黄酒、八角桂皮，加入酱油与清水小火焖；\n3) 以糖和醋反复调味，收汁浓亮，层次甘香酸甜。
九转鸡	鲁菜	1) 鸡反复清洗焯水去腥；\n2) 炒糖色，下主料与葱姜蒜、黄酒、八角桂皮，加入酱油与清水小火焖；\n3) 以糖和醋反复调味，收汁浓亮，层次甘香酸甜。
九转里脊	鲁菜	1) 里脊反复清洗焯水去腥；\n2) 炒糖色，下主料与葱姜蒜、黄酒、八角桂皮，加入酱油与清水小火焖；\n3) 以糖和醋反复调味，收汁浓亮，层次甘香酸甜。
九转虾	鲁菜	1) 虾反复清洗焯水去腥；\n2) 炒糖色，下主料与葱姜蒜、黄酒、八角桂皮，加入酱油与清水小火焖；\n3) 以糖和醋反复调味，收汁浓亮，层次甘香酸甜。
九转带鱼	鲁菜	1) 带鱼反复清洗焯水去腥；\n2) 炒糖色，下主料与葱姜蒜、黄酒、八角桂皮，加入酱油与清水小火焖；\n3) 以糖和醋反复调味，收汁浓亮，层次甘香酸甜。
九转鱿鱼	鲁菜	1) 鱿鱼反复清洗焯水去腥；\n2) 炒糖色，下主料与葱姜蒜、黄酒、八角桂皮，加入酱油与清水小火焖；\n3) 以糖和醋反复调味，收汁浓亮，层次甘香酸甜。
九转鳜鱼	鲁菜	1) 鳜鱼反复清洗焯水去腥；\n2) 炒糖色，下主料与葱姜蒜、黄酒、八角桂皮，加入酱油与清水小火焖；\n3) 以糖和醋反复调味，收汁浓亮，层次甘香酸甜。
九转蛤蜊	鲁菜	1) 蛤蜊反复清洗焯水去腥；\n2) 炒糖色，下主料与葱姜蒜、黄酒、八角桂皮，加入酱油与清水小火焖；\n3) 以糖和醋反复调味，收汁浓亮，层次甘香酸甜。
九转扇贝	鲁菜	1) 扇贝反复清洗焯水去腥；\n2) 炒糖色，下主料与葱姜蒜、黄酒、八角桂皮，加入酱油与清水小火焖；\n3) 以糖和醋反复调味，收汁浓亮，层次甘香酸甜。
九转羊肉	鲁菜	1) 羊肉反复清洗焯水去腥；\n2) 炒糖色，下主料与葱姜蒜、黄酒、八角桂皮，加入酱油与清水小火焖；\n3) 以糖和醋反复调味，收汁浓亮，层次甘香酸甜。
九转菜花	鲁菜	1) 菜花反复清洗焯水去腥；\n2) 炒糖色，下主料与葱姜蒜、黄酒、八角桂皮，加入酱油与清水小火焖；\n3) 以糖和醋反复调味，收汁浓亮，层次甘香酸甜。
九转土豆	鲁菜	1) 土豆反复清洗焯水去腥；\n2) 炒糖色，下主料与葱姜蒜、黄酒、八角桂皮，加入酱油与清水小火焖；\n3) 以糖和醋反复调味，收汁浓亮，层次甘香酸甜。
九转茄子	鲁菜	1) 茄子反复清洗焯水去腥；\n2) 炒糖色，下主料与葱姜蒜、黄酒、八角桂皮，加入酱油与清水小火焖；\n3) 以糖和醋反复调味，收汁浓亮，层次甘香酸甜。
九转豆腐	鲁菜	1) 豆腐反复清洗焯水去腥；\n2) 炒糖色，下主料与葱姜蒜、黄酒、八角桂皮，加入酱油与清水小火焖；\n3) 以糖和醋反复调味，收汁浓亮，层次甘香酸甜。
九转丸子	鲁菜	1) 丸子反复清洗焯水去腥；\n2) 炒糖色，下主料与葱姜蒜、黄酒、八角桂皮，加入酱油与清水小火焖；\n3) 以糖和醋反复调味，收汁浓亮，层次甘香酸甜。
九转鲫鱼	鲁菜	1) 鲫鱼反复清洗焯水去腥；\n2) 炒糖色，下主料与葱姜蒜、黄酒、八角桂皮，加入酱油与清水小火焖；\n3) 以糖和醋反复调味，收汁浓亮，层次甘香酸甜。
糖醋大肠	鲁菜	1) 大肠处理后干煎/炸至定型；\n2) 调糖醋汁（糖:醋≈2:1，酱油少许、清水与淀粉），入锅煮至透亮；\n3) 回锅裹匀翻炒，酸甜开胃。
糖醋海参	鲁菜	1) 海参处理后干煎/炸至定型；\n2) 调糖醋汁（糖:醋≈2:1，酱油少许、清水与淀粉），入锅煮至透亮；\n3) 回锅裹匀翻炒，酸甜开胃。
糖醋肘子	鲁菜	1) 肘子处理后干煎/炸至定型；\n2) 调糖醋汁（糖:醋≈2:1，酱油少许、清水与淀粉），入锅煮至透亮；\n3) 回锅裹匀翻炒，酸甜开胃。
糖醋鸡	鲁菜	1) 鸡处理后干煎/炸至定型；\n2) 调糖醋汁（糖:醋≈2:1，酱油少许、清水与淀粉），入锅煮至透亮；\n3) 回锅裹匀翻炒，酸甜开胃。
糖醋虾	鲁菜	1) 虾处理后干煎/炸至定型；\n2) 调糖醋汁（糖:醋≈2:1，酱油少许、清水与淀粉），入锅煮至透亮；\n3) 回锅裹匀翻炒，酸甜开胃。
糖醋带鱼	鲁菜	1) 带鱼处理后干煎/炸至定型；\n2) 调糖醋汁（糖:醋≈2:1，酱油少许、清水与淀粉），入锅煮至透亮；\n3) 回锅裹匀翻炒，酸甜开胃。
糖醋鱿鱼	鲁菜	1) 鱿鱼处理后干煎/炸至定型；\n2) 调糖醋汁（糖:醋≈2:1，酱油少许、清水与淀粉），入锅煮至透亮；\n3) 回锅裹匀翻炒，酸甜开胃。
糖醋鳜鱼	鲁菜	1) 鳜鱼处理后干煎/炸至定型；\n2) 调糖醋汁（糖:醋≈2:1，酱油少许、清水与淀粉），入锅煮至透亮；\n3) 回锅裹匀翻炒，酸甜开胃。
糖醋蛤蜊	鲁菜	1) 蛤蜊处理后干煎/炸至定型；\n2) 调糖醋汁（糖:醋≈2:1，酱油少许、清水与淀粉），入锅煮至透亮；\n3) 回锅裹匀翻炒，酸甜开胃。
糖醋扇贝	鲁菜	1) 扇贝处理后干煎/炸至定型；\n2) 调糖醋汁（糖:醋≈2:1，酱油少许、清水与淀粉），入锅煮至透亮；\n3) 回锅裹匀翻炒，酸甜开胃。
糖醋羊肉	鲁菜	1) 羊肉处理后干煎/炸至定型；\n2) 调糖醋汁（糖:醋≈2:1，酱油少许、清水与淀粉），入锅煮至透亮；\n3) 回锅裹匀翻炒，酸甜开胃。
糖醋菜花	鲁菜	1) 菜花处理后干煎/炸至定型；\n2) 调糖醋汁（糖:醋≈2:1，酱油少许、清水与淀粉），入锅煮至透亮；\n3) 回锅裹匀翻炒，酸甜开胃。
糖醋土豆	鲁菜	1) 土豆处理后干煎/炸至定型；\n2) 调糖醋汁（糖:醋≈2:1，酱油少许、清水与淀粉），入锅煮至透亮；\n3) 回锅裹匀翻炒，酸甜开胃。
糖醋茄子	鲁菜	1) 茄子处理后干煎/炸至定型；\n2) 调糖醋汁（糖:醋≈2:1，酱油少许、清水与淀粉），入锅煮至透亮；\n3) 回锅裹匀翻炒，酸甜开胃。
糖醋豆腐	鲁菜	1) 豆腐处理后干煎/炸至定型；\n2) 调糖醋汁（糖:醋≈2:1，酱油少许、清水与淀粉），入锅煮至透亮；\n3) 回锅裹匀翻炒，酸甜开胃。
糖醋丸子	鲁菜	1) 丸子处理后干煎/炸至定型；\n2) 调糖醋汁（糖:醋≈2:1，酱油少许、清水与淀粉），入锅煮至透亮；\n3) 回锅裹匀翻炒，酸甜开胃。
糖醋鲫鱼	鲁菜	1) 鲫鱼处理后干煎/炸至定型；\n2) 调糖醋汁（糖:醋≈2:1，酱油少许、清水与淀粉），入锅煮至透亮；\n3) 回锅裹匀翻炒，酸甜开胃。
葱烧大肠	鲁菜	1) 大量大葱段小火炸至微焦出香；\n2) 入大肠与生抽/老抽/糖/黄酒/高汤，小火焖至葱香入骨；\n3) 出锅前略收汁。
葱烧鲤鱼	鲁菜	1) 大量大葱段小火炸至微焦出香；\n2) 入鲤鱼与生抽/老抽/糖/黄酒/高汤，小火焖至葱香入骨；\n3) 出锅前略收汁。
葱烧肘子	鲁菜	1) 大量大葱段小火炸至微焦出香；\n2) 入肘子与生抽/老抽/糖/黄酒/高汤，小火焖至葱香入骨；\n3) 出锅前略收汁。
葱烧鸡	鲁菜	1) 大量大葱段小火炸至微焦出香；\n2) 入鸡与生抽/老抽/糖/黄酒/高汤，小火焖至葱香入骨；\n3) 出锅前略收汁。
葱烧里脊	鲁菜	1) 大量大葱段小火炸至微焦出香；\n2) 入里脊与生抽/老抽/糖/黄酒/高汤，小火焖至葱香入骨；\n3) 出锅前略收汁。
葱烧虾	鲁菜	1) 大量大葱段小火炸至微焦出香；\n2) 入虾与生抽/老抽/糖/黄酒/高汤，小火焖至葱香入骨；\n3) 出锅前略收汁。
葱烧带鱼	鲁菜	1) 大量大葱段小火炸至微焦出香；\n2) 入带鱼与生抽/老抽/糖/黄酒/高汤，小火焖至葱香入骨；\n3) 出锅前略收汁。
葱烧鱿鱼	鲁菜	1) 大量大葱段小火炸至微焦出香；\n2) 入鱿鱼与生抽/老抽/糖/黄酒/高汤，小火焖至葱香入骨；\n3) 出锅前略收汁。
葱烧鳜鱼	鲁菜	1) 大量大葱段小火炸至微焦出香；\n2) 入鳜鱼与生抽/老抽/糖/黄酒/高汤，小火焖至葱香入骨；\n3) 出锅前略收汁。
葱烧蛤蜊	鲁菜	1) 大量大葱段小火炸至微焦出香；\n2) 入蛤蜊与生抽/老抽/糖/黄酒/高汤，小火焖至葱香入骨；\n3) 出锅前略收汁。
葱烧扇贝	鲁菜	1) 大量大葱段小火炸至微焦出香；\n2) 入扇贝与生抽/老抽/糖/黄酒/高汤，小火焖至葱香入骨；\n3) 出锅前略收汁。
葱烧羊肉	鲁菜	1) 大量大葱段小火炸至微焦出香；\n2) 入羊肉与生抽/老抽/糖/黄酒/高汤，小火焖至葱香入骨；\n3) 出锅前略收汁。
葱烧菜花	鲁菜	1) 大量大葱段小火炸至微焦出香；\n2) 入菜花与生抽/老抽/糖/黄酒/高汤，小火焖至葱香入骨；\n3) 出锅前略收汁。
葱烧土豆	鲁菜	1) 大量大葱段小火炸至微焦出香；\n2) 入土豆与生抽/老抽/糖/黄酒/高汤，小火焖至葱香入骨；\n3) 出锅前略收汁。
葱烧茄子	鲁菜	1) 大量大葱段小火炸至微焦出香；\n2) 入茄子与生抽/老抽/糖/黄酒/高汤，小火焖至葱香入骨；\n3) 出锅前略收汁。
葱烧豆腐	鲁菜	1) 大量大葱段小火炸至微焦出香；\n2) 入豆腐与生抽/老抽/糖/黄酒/高汤，小火焖至葱香入骨；\n3) 出锅前略收汁。
葱烧丸子	鲁菜	1) 大量大葱段小火炸至微焦出香；\n2) 入丸子与生抽/老抽/糖/黄酒/高汤，小火焖至葱香入骨；\n3) 出锅前略收汁。
扒大肠	鲁菜	1) 大肠先煎至定型，再加清汤与少许盐、胡椒；\n2) 小火煨至软嫩，原汤勾薄芡，口味清雅。
扒鲤鱼	鲁菜	1) 鲤鱼先煎至定型，再加清汤与少许盐、胡椒；\n2) 小火煨至软嫩，原汤勾薄芡，口味清雅。
扒肘子	鲁菜	1) 肘子先煎至定型，再加清汤与少许盐、胡椒；\n2) 小火煨至软嫩，原汤勾薄芡，口味清雅。
扒鸡	鲁菜	1) 鸡先煎至定型，再加清汤与少许盐、胡椒；\n2) 小火煨至软嫩，原汤勾薄芡，口味清雅。
扒里脊	鲁菜	1) 里脊先煎至定型，再加清汤与少许盐、胡椒；\n2) 小火煨至软嫩，原汤勾薄芡，口味清雅。
扒虾	鲁菜	1) 虾先煎至定型，再加清汤与少许盐、胡椒；\n2) 小火煨至软嫩，原汤勾薄芡，口味清雅。
扒带鱼	鲁菜	1) 带鱼先煎至定型，再加清汤与少许盐、胡椒；\n2) 小火煨至软嫩，原汤勾薄芡，口味清雅。
扒鱿鱼	鲁菜	1) 鱿鱼先煎至定型，再加清汤与少许盐、胡椒；\n2) 小火煨至软嫩，原汤勾薄芡，口味清雅。
扒鳜鱼	鲁菜	1) 鳜鱼先煎至定型，再加清汤与少许盐、胡椒；\n2) 小火煨至软嫩，原汤勾薄芡，口味清雅。
扒蛤蜊	鲁菜	1) 蛤蜊先煎至定型，再加清汤与少许盐、胡椒；\n2) 小火煨至软嫩，原汤勾薄芡，口味清雅。
扒扇贝	鲁菜	1) 扇贝先煎至定型，再加清汤与少许盐、胡椒；\n2) 小火煨至软嫩，原汤勾薄芡，口味清雅。
扒羊肉	鲁菜	1) 羊肉先煎至定型，再加清汤与少许盐、胡椒；\n2) 小火煨至软嫩，原汤勾薄芡，口味清雅。
扒菜花	鲁菜	1) 菜花先煎至定型，再加清汤与少许盐、胡椒；\n2) 小火煨至软嫩，原汤勾薄芡，口味清雅。
扒土豆	鲁菜	1) 土豆先煎至定型，再加清汤与少许盐、胡椒；\n2) 小火煨至软嫩，原汤勾薄芡，口味清雅。
扒茄子	鲁菜	1) 茄子先煎至定型，再加清汤与少许盐、胡椒；\n2) 小火煨至软嫩，原汤勾薄芡，口味清雅。
扒豆腐	鲁菜	1) 豆腐先煎至定型，再加清汤与少许盐、胡椒；\n2) 小火煨至软嫩，原汤勾薄芡，口味清雅。
扒丸子	鲁菜	1) 丸子先煎至定型，再加清汤与少许盐、胡椒；\n2) 小火煨至软嫩，原汤勾薄芡，口味清雅。
扒鲫鱼	鲁菜	1) 鲫鱼先煎至定型，再加清汤与少许盐、胡椒；\n2) 小火煨至软嫩，原汤勾薄芡，口味清雅。
清汤大肠	鲁菜	1) 上好清汤与大肠同煮，小火保持清亮不混；\n2) 以盐与胡椒轻调味，突出本味。
清汤鲤鱼	鲁菜	1) 上好清汤与鲤鱼同煮，小火保持清亮不混；\n2) 以盐与胡椒轻调味，突出本味。
清汤海参	鲁菜	1) 上好清汤与海参同煮，小火保持清亮不混；\n2) 以盐与胡椒轻调味，突出本味。
清汤肘子	鲁菜	1) 上好清汤与肘子同煮，小火保持清亮不混；\n2) 以盐与胡椒轻调味，突出本味。
清汤鸡	鲁菜	1) 上好清汤与鸡同煮，小火保持清亮不混；\n2) 以盐与胡椒轻调味，突出本味。
清汤里脊	鲁菜	1) 上好清汤与里脊同煮，小火保持清亮不混；\n2) 以盐与胡椒轻调味，突出本味。
清汤虾	鲁菜	1) 上好清汤与虾同煮，小火保持清亮不混；\n2) 以盐与胡椒轻调味，突出本味。
清汤带鱼	鲁菜	1) 上好清汤与带鱼同煮，小火保持清亮不混；\n2) 以盐与胡椒轻调味，突出本味。
清汤鱿鱼	鲁菜	1) 上好清汤与鱿鱼同煮，小火保持清亮不混；\n2) 以盐与胡椒轻调味，突出本味。
清汤鳜鱼	鲁菜	1) 上好清汤与鳜鱼同煮，小火保持清亮不混；\n2) 以盐与胡椒轻调味，突出本味。
